30 100
CGACATGGACTCGATATCCACAGACCACCA|GACATAGTGGGTATATGTTTGATCCCGACA
TATGTTTGATCCCGACATAGTGGGTACCCG|TGCAAATACTTAAAGCGGTGCCTCTCTGGT
CGCTTGCTATCGAGCAAAAATTATTTGACT|ATGTTTTATGTTTGATCCCGACATAGTGGG
ATGTTTGATCCCGACATAGTGGGTACCCGA|TTTGACTCCGAAAACGAGTCGACATGGACT
TTGATCCCGACATAGTGGGTACCCGAAGTC|ACTCCGAAAACGAGTCGACATGGACTCGAT
ACCCGACAAGGCGAACTCTATCTTATAACG|CACCGCTGAAACCGCAGGCTTAAAATAAAG
CTTTTAGTGCTCTTCATTCGACATGTTCTA|CATAGTGGGTACCCGCCGGGACACACAATC
CATGAATCCGCGCGTACGGGGTCGGTATGT|CCGACATAGTGGGTACCCGAAGTCGTAAAT
GGCTTAAAATAAAGAGATCGGAATATGTGG|CAGAACACTCCTCAAGTTAGCATGGCAGAG
ATCATGGAGAACCCTCACAGCTATGTTTGA|ACTGGACGCTTTATCGTCTACGTGCGATCC
GCCGTATGTTTGATCCCGACATAGTGGGTA|GTTTGATCCCGACATAGTGGGTACTATGTT
CGGAGGAGCTGCGTATCACCGCTGAAACCG|GGTGGGTCAGCGTAGTTGTTACTGAACACG
GGCCGCTTGCTATCGAGCAAAAATTATTTG|AATATGTTTTATGTTTGATCCCGACATAGT
TACGTATATTTACAGATAAGCCAACCTGCC|GACCGTTCAATTATCTTATGTTATGTTTGA
ATATTTACAGATAAGCCAACCTGCCCAACT|TTCAATTATCTTATGTTATGTTTGATCCCG
GCCGAGTAAATACTTGCTTAACCCCAGCGG|AGGCATCATGGAGAACCCTCACAGCTATGT
CAGGCGGCAATAATCTCATTACGCAATGAA|GCTTGCACTTGTCACCTAACTACTGAGCGC
CCCGACATAGTGGGTATATGTTTGATCCCG|TAGGCTGAGGGACTTTGATTTCATAAAAAT
CATAGTGGGTACCCGAAGTCGTAAATGAGG|CGAGTCGACATGGACTCGATATCCACAGAC
TAGTGGGTACCCGCCCGATCTGAGTCGCCC|TAAAAGCAGCCCGCCGAGTAAATACTTGCT
TTGGTCCAAAGAATACGTATATTTACAGAT|CGAAAACACGCTCGACCGTTCAATTATCTT
GTGGGTACCCGCCGGGTAGCACAGACCTTG|TGATCCCGACATAGTGGGTACCCGAATGTA
GATCCCGACATAGTGGGTACCCGTATGTTT|CGGTATGTATGTTTGATCCTATGTTTGATC
TGGGTACCCGCGGCCGAAAACACGCTCGAC|TATGTTTGATCCCGACATAGTGGGTACCCG
ATGTTTGATCCCGACATAGTGGGTACTATG|TTGATCCCGACATAGTGGGTACCCGCGACA
ACATTAGAGGATCAAGATAGGCTGAGGGAC|AATGGTGAAGCTGACTAAAGCAAAGGGGCC
ATAGTGGGTACCCGCCCGATCTGAGTCGCC|TTAAAAGCAGCCCGCCGAGTAAATACTTGC
GCTGATAGCTGGCCGTATGTTTGATCCCGA|GGTACCCGTATGTTTGATCCCGACATAGTG
CACACAATCCACACTGGACGCTTTATCGTC|TGAAGAATCTTGCAAAGTTCCCAGACGATC
GGAGCTGCGTATCACCGCTGAAACCGCAGG|GGTCAGCGTAGTTGTTACTGAACACGAACA
TGATCCCGACATAGTGGGTACCCGTATGTT|TCGGTATGTATGTTTGATCCTATGTTTGAT
CCGAAAACACGCTCGACCGTTCAATTATCT|GACATAGTGGGTACCCGCCGGGTAGCACAG
CAATGAAGAATCTTGCAAAGTTCCCAGACG|TGAGCGCATACATGCTTTGAGCTTTTTACT
AGCTATGTTTGATCCCGACATAGTGGGTAC|TCGGAATATGTGGCAGGCGGCAATAATCTC
TCCAATTACCATACGTATATAGGCAAAGTG|GGACTTGTGCAATTTATTGTCTGTGTCTTG
TGACTAAAGCAAAGGGGCCTGCCTTTTAGT|GCAGAGCTATGTTTGATCCCGACATAGTGG
TGGGTACCCGCTTACCGATGGTGGTATAGG|CCTCTCTGGTTATCTTCGGACCTGTATGAA
CCATCGCAGCTGCAAATACTTAAAGCGGTG|ACATAGTGGGTACCCGCCCGATCTGAGTCG
TGCTATCGAGCAAAAATTATTTGACTCCGA|TTTATGTTTGATCCCGACATAGTGGGTACC
AGCAAAGGGGCCTGCCTTTTAGTGCTCTTC|TATGTTTGATCCCGACATAGTGGGTACCCG
TAGTGGGTACCCGCCGGGTAGCACAGACCT|TTTGATCCCGACATAGTGGGTACCCGAATG
TTTATCGTCTACGTGCGATCCCGGAGGAGC|CAGACGATCAGCCACCAAGCGGGTGGGTCA
AGACCTTGTAGAAAAATCATGAATCCGCGC|CGAATGTATGTTTGATCCCGACATAGTGGG
ACCCGCCGGGTAGCACAGACCTTGTAGAAA|CGACATAGTGGGTACCCGAATGTATGTTTG
AAAGTGCACATTAGAGGATCAAGATAGGCT|GTCTTGTAATGGTGAAGCTGACTAAAGCAA
GAGGGACTTTGATTTCATAAAAATAATTAA|AGGGGCCTGCCTTTTAGTGCTCTTCATTCG
TAGGCAAAGTGCACATTAGAGGATCAAGAT|TCTGTGTCTTGTAATGGTGAAGCTGACTAA
ACTATGTTTGATCCCGACATAGTGGGTACC|GCGACATAGTGGGTACCCGTTTGATCCCGA
AAGTCGTAAATGAGGTGCAGCCATCTTTAT|TCGATATCCACAGACCACCATCGCAGCTGC
CGCAACTGCGCTGAATCAATACGGTTGCTG|GGGTACCCGTTGATCCCGACATAGTGGGTA
GTACCCGAATGTATGTTTGATCCCGACATA|GAGCAAAAATTATTTGACTCCGAAAACGAG
GGGTACCCGTTTGATCCCGACATAGTGGGT|CCGATGGTGGTATAGGCCGCTTGCTATCGA
ACAGATAAGCCAACCTGCCCAACTGGAAAA|TATCTTATGTTATGTTTGATCCCGACATAG
ACATGTTCTAGGCATCATGGAGAACCCTCA|ACACACAATCCACACTGGACGCTTTATCGT
ATAAGCCAACCTGCCCAACTGGAAAAGCGC|TTATGTTATGTTTGATCCCGACATAGTGGG
TTACCGATGGTGGTATAGGCCGCTTGCTAT|ATCTTCGGACCTGTATGAATATGTTTTATG
CCCGCCGAGTAAATACTTGCTTAACCCCAG|TCTAGGCATCATGGAGAACCCTCACAGCTA
TGATCCAATTACCATACGTATATAGGCAAA|TATGGACTTGTGCAATTTATTGTCTGTGTC
ACAAGGCGAACTCTATCTTATAACGCAGAG|CTGAAACCGCAGGCTTAAAATAAAGAGATC
CCGACATAGTGGGTACCCGCGACATAGTGG|TGATCCCGACATAGTGGGTACCCGCTTACC
ATGGTGGTATAGGCCGCTTGCTATCGAGCA|GGACCTGTATGAATATGTTTTATGTTTGAT
GGTGCCTCTCTGGTTATCTTCGGACCTGTA|GTCGCCCGCTATGGTTGGAGTTTTGATCCA
CAAGATAGGCTGAGGGACTTTGATTTCATA|GACTAAAGCAAAGGGGCCTGCCTTTTAGTG
AAAATCATGAATCCGCGCGTACGGGGTCGG|TGATCCCGACATAGTGGGTACCCGAAGTCG
CTACGTGCGATCCCGGAGGAGCTGCGTATC|CAGCCACCAAGCGGGTGGGTCAGCGTAGTT
CGACATAGTGGGTACCCGCGGCCGAAAACA|GTGGGTACTATGTTTGATCCCGACATAGTG
GGTACCCGCGGCCGAAAACACGCTCGACCG|TGTTTGATCCCGACATAGTGGGTACCCGCC
CTTGTAGAAAAATCATGAATCCGCGCGTAC|TGTATGTTTGATCCCGACATAGTGGGTACC
ATGTTTGATCCCGACATAGTGGGTACCCGC|TCTTTATGTTTGATCCCGACATAGTGGGTA
TGTTTGATCCCGACATAGTGGGTACCCGGA|TATAGGCAAAGTGCACATTAGAGGATCAAG
ACCCGTTGATCCCGACATAGTGGGTACCCG|ACGGGGTCGGTATGTATGTTTGATCCTATG
TGGACTTGTGCAATTTATTGTCTGTGTCTT|CCGACATAGTGGGTACCCGACAAGGCGAAC
TATCGAGCAAAAATTATTTGACTCCGAAAA|ATGTTTGATCCCGACATAGTGGGTACCCGG
TCGATATCCACAGACCACCATCGCAGCTGC|GTATATGTTTGATCCCGACATAGTGGGTAC
AAGTTCCCAGACGATCAGCCACCAAGCGGG|TGAGCTTTTTACTCTGGCAAATTGTTTCAA
CGGCAATAATCTCATTACGCAATGAAGAAT|GCACTTGTCACCTAACTACTGAGCGCATAC
TTGATCCCGACATAGTGGGTACCCGCCGGG|TGTGGCAGGCGGCAATAATCTCATTACGCA
ATCTTATAACGCAGAGCTATGTTTGATCCC|TTAAAATAAAGAGATCGGAATATGTGGCAG
TGGAGAACCCTCACAGCTATGTTTGATCCC|GACGCTTTATCGTCTACGTGCGATCCCGGA
TCTTGTAATGGTGAAGCTGACTAAAGCAAA|GAACTCTATCTTATAACGCAGAGCTATGTT
GACTTGTGCAATTTATTGTCTGTGTCTTGT|GACATAGTGGGTACCCGACAAGGCGAACTC
ATAGTGGGTACCCGCGGCCGAAAACACGCT|GTACTATGTTTGATCCCGACATAGTGGGTA
GTTCCCAGACGATCAGCCACCAAGCGGGTG|AGCTTTTTACTCTGGCAAATTGTTTCAAAA
GCGCTGAATCAATACGGTTGCTGATAGCTG|CGTTGATCCCGACATAGTGGGTACCCGTAT
TTAGAGGATCAAGATAGGCTGAGGGACTTT|GGTGAAGCTGACTAAAGCAAAGGGGCCTGC
AGAGGATCAAGATAGGCTGAGGGACTTTGA|TGAAGCTGACTAAAGCAAAGGGGCCTGCCT
ACGCAGAGCTATGTTTGATCCCGACATAGT|AAGAGATCGGAATATGTGGCAGGCGGCAAT
CCTTGTAGAAAAATCATGAATCCGCGCGTA|ATGTATGTTTGATCCCGACATAGTGGGTAC
CCCGCTTACCGATGGTGGTATAGGCCGCTT|TGGTTATCTTCGGACCTGTATGAATATGTT
TCCGAAAACGAGTCGACATGGACTCGATAT|GTACCCGGATCCCGACATAGTGGGTATATG
ACATAGTGGGTACCCGAATGTATGTTTGAT|CTTGCTATCGAGCAAAAATTATTTGACTCC
AACTGCGCTGAATCAATACGGTTGCTGATA|TACCCGTTGATCCCGACATAGTGGGTACCC
ATCGAGCAAAAATTATTTGACTCCGAAAAC|TGTTTGATCCCGACATAGTGGGTACCCGGA
TACCATACGTATATAGGCAAAGTGCACATT|GTGCAATTTATTGTCTGTGTCTTGTAATGG
TCGGACCTGTATGAATATGTTTTATGTTTG|GTTTTGATCCAATTACCATACGTATATAGG
TCTTATGTTATGTTTGATCCCGACATAGTG|CAGACCTTGTAGAAAAATCATGAATCCGCG
TTAACCCCAGCGGAGTGTATGGACTTGTGC|CTCACAGCTATGTTTGATCCCGACATAGTG
AGGGGCCTGCCTTTTAGTGCTCTTCATTCG|TTGATCCCGACATAGTGGGTACCCGCCGGG
AGCTATGTTTGATCCCGACATAGTGGGTAC|TACGTGCGATCCCGGAGGAGCTGCGTATCA
CGAATGTATGTTTGATCCCGACATAGTGGG|AAAATTATTTGACTCCGAAAACGAGTCGAC
GGGACACACAATCCACACTGGACGCTTTAT|GCAATGAAGAATCTTGCAAAGTTCCCAGAC
TGATCCCGACATAGTGGGTACCCGTTGATC|AAATCATGAATCCGCGCGTACGGGGTCGGT
TCGGTATGTATGTTTGATCCTATGTTTGAT|GTCGTAAATGAGGTGCAGCCATCTTTATGT
CATCGCAGCTGCAAATACTTAAAGCGGTGC|CATAGTGGGTACCCGCCCGATCTGAGTCGC
CCGCCGGGACACACAATCCACACTGGACGC|ATTACGCAATGAAGAATCTTGCAAAGTTCC
TAGTGGGTACCCGACAAGGCGAACTCTATC|CTGCGTATCACCGCTGAAACCGCAGGCTTA
TCCACAGACCACCATCGCAGCTGCAAATAC|GTTTGATCCCGACATAGTGGGTACCCGCCC
TTTGATCCCGACATAGTGGGTACCCGCCGG|TAGTGGGTACCCGTTTGATCCCGACATAGT
TTATCTTCGGACCTGTATGAATATGTTTTA|GTTGGAGTTTTGATCCAATTACCATACGTA
CATTAGAGGATCAAGATAGGCTGAGGGACT|ATGGTGAAGCTGACTAAAGCAAAGGGGCCT
CGAAAACGAGTCGACATGGACTCGATATCC|ACCCGGATCCCGACATAGTGGGTATATGTT
AATTATCTTATGTTATGTTTGATCCCGACA|TAGCACAGACCTTGTAGAAAAATCATGAAT
TGATTTCATAAAAATAATTAAAAGCAGCCC|CCTTTTAGTGCTCTTCATTCGACATGTTCT
CGGTTGCTGATAGCTGGCCGTATGTTTGAT|TAGTGGGTACCCGTATGTTTGATCCCGACA
TTATGTTTGATCCCGACATAGTGGGTACCC|GTATATAGGCAAAGTGCACATTAGAGGATC
AGTGGGTACCCGCCGGGTAGCACAGACCTT|TTGATCCCGACATAGTGGGTACCCGAATGT
TATGGTTGGAGTTTTGATCCAATTACCATA|ACCCCAGCGGAGTGTATGGACTTGTGCAAT
TTTGATCCCGACATAGTGGGTACCCGAATG|GTATAGGCCGCTTGCTATCGAGCAAAAATT
GGGTACCCGCGGCCGAAAACACGCTCGACC|ATGTTTGATCCCGACATAGTGGGTACCCGC
GGCGGCAATAATCTCATTACGCAATGAAGA|TTGCACTTGTCACCTAACTACTGAGCGCAT
GCTGCGTATCACCGCTGAAACCGCAGGCTT|CAGCGTAGTTGTTACTGAACACGAACAGAA
GTTTGATCCCGACATAGTGGGTACCCGAAT|GGTATAGGCCGCTTGCTATCGAGCAAAAAT
CCCGCCGGGTAGCACAGACCTTGTAGAAAA|GACATAGTGGGTACCCGAATGTATGTTTGA
AGTGGGTACCCGCCCGATCTGAGTCGCCCG|AAAAGCAGCCCGCCGAGTAAATACTTGCTT
TTCATTCGACATGTTCTAGGCATCATGGAG|CCGCCGGGACACACAATCCACACTGGACGC
CCGTATGTTTGATCCCGACATAGTGGGTAC|TTTGATCCCGACATAGTGGGTACTATGTTT
AAACACGCTCGACCGTTCAATTATCTTATG|TAGTGGGTACCCGCCGGGTAGCACAGACCT
TAGCTGGCCGTATGTTTGATCCCGACATAG|CCGTATGTTTGATCCCGACATAGTGGGTAC
AATCCGCGCGTACGGGGTCGGTATGTATGT|CATAGTGGGTACCCGAAGTCGTAAATGAGG
CGGTGCCTCTCTGGTTATCTTCGGACCTGT|AGTCGCCCGCTATGGTTGGAGTTTTGATCC
GACATAGTGGGTACCCGCGGCCGAAAACAC|TGGGTACTATGTTTGATCCCGACATAGTGG
CGACATAGTGGGTACCCGCCGGGACACACA|GGCGGCAATAATCTCATTACGCAATGAAGA
GTTGATCCCGACATAGTGGGTACCCGTATG|GGTCGGTATGTATGTTTGATCCTATGTTTG
GTTTGATCCCGACATAGTGGGTACTATGTT|GATCCCGACATAGTGGGTACCCGCGACATA
GGGACTTTGATTTCATAAAAATAATTAAAA|GGGCCTGCCTTTTAGTGCTCTTCATTCGAC
CAATCCACACTGGACGCTTTATCGTCTACG|GAATCTTGCAAAGTTCCCAGACGATCAGCC
TCCCGACATAGTGGGTACCCGCGACATAGT|TTTGATCCCGACATAGTGGGTACCCGCTTA
GAACTCTATCTTATAACGCAGAGCTATGTT|CGCAGGCTTAAAATAAAGAGATCGGAATAT
TGATCCTATGTTTGATCCCGACATAGTGGG|GCAGCCATCTTTATGTTTGATCCCGACATA
GGATCAAGATAGGCTGAGGGACTTTGATTT|AGCTGACTAAAGCAAAGGGGCCTGCCTTTT
TATTGTCTGTGTCTTGTAATGGTGAAGCTG|CCCGACAAGGCGAACTCTATCTTATAACGC
GTGGGTATATGTTTGATCCCGACATAGTGG|GGACTTTGATTTCATAAAAATAATTAAAAG
GAACCCTCACAGCTATGTTTGATCCCGACA|CTTTATCGTCTACGTGCGATCCCGGAGGAG
CCGTTCAATTATCTTATGTTATGTTTGATC|GCCGGGTAGCACAGACCTTGTAGAAAAATC
TAGGCTGAGGGACTTTGATTTCATAAAAAT|AAGCAAAGGGGCCTGCCTTTTAGTGCTCTT
TGATCCCGACATAGTGGGTACCCGACAAGG|TCCCGGAGGAGCTGCGTATCACCGCTGAAA
CGATCTGAGTCGCCCGCTATGGTTGGAGTT|GAGTAAATACTTGCTTAACCCCAGCGGAGT
TTTGATCCTATGTTTGATCCCGACATAGTG|GTGCAGCCATCTTTATGTTTGATCCCGACA
AGAATCTTGCAAAGTTCCCAGACGATCAGC|CATACATGCTTTGAGCTTTTTACTCTGGCA
CGTATATAGGCAAAGTGCACATTAGAGGAT|TTATTGTCTGTGTCTTGTAATGGTGAAGCT
ACTGCGCTGAATCAATACGGTTGCTGATAG|ACCCGTTGATCCCGACATAGTGGGTACCCG
TCTTGCAAAGTTCCCAGACGATCAGCCACC|CATGCTTTGAGCTTTTTACTCTGGCAAATT
TTAAAGCGGTGCCTCTCTGGTTATCTTCGG|GATCTGAGTCGCCCGCTATGGTTGGAGTTT
GTTTGATCCCGACATAGTGGGTACCCGTTG|GAAAAATCATGAATCCGCGCGTACGGGGTC
TGCCCAACTGGAAAAGCGCAACTGCGCTGA|TTGATCCCGACATAGTGGGTACCCGTTGAT
GTTTGATCCCGACATAGTGGGTACCCGAAG|TGACTCCGAAAACGAGTCGACATGGACTCG
GAGGAGCTGCGTATCACCGCTGAAACCGCA|TGGGTCAGCGTAGTTGTTACTGAACACGAA
GCGTACGGGGTCGGTATGTATGTTTGATCC|GGTACCCGAAGTCGTAAATGAGGTGCAGCC
AGTGGGTACTATGTTTGATCCCGACATAGT|GGTACCCGCGACATAGTGGGTACCCGTTTG
AGTGGGTACCCGTTTGATCCCGACATAGTG|TTACCGATGGTGGTATAGGCCGCTTGCTAT
GTTCGGCAGTTGGTCCAAAGAATACGTATA|ACCCGCGGCCGAAAACACGCTCGACCGTTC
CTGCAAATACTTAAAGCGGTGCCTCTCTGG|GTACCCGCCCGATCTGAGTCGCCCGCTATG
TGATCCCGACATAGTGGGTACTATGTTTGA|CCCGACATAGTGGGTACCCGCGACATAGTG
ATCCCGACATAGTGGGTACCCGAAGTCGTA|CCGAAAACGAGTCGACATGGACTCGATATC
AATTATTTGACTCCGAAAACGAGTCGACAT|CGACATAGTGGGTACCCGGATCCCGACATA
CTTGTGCAATTTATTGTCTGTGTCTTGTAA|CATAGTGGGTACCCGACAAGGCGAACTCTA
GTGGGTACCCGAAGTCGTAAATGAGGTGCA|TCGACATGGACTCGATATCCACAGACCACC
TGGTATAGGCCGCTTGCTATCGAGCAAAAA|CTGTATGAATATGTTTTATGTTTGATCCCG
CAAAGTTCCCAGACGATCAGCCACCAAGCG|TTTGAGCTTTTTACTCTGGCAAATTGTTTC
GGGTACCCGTATGTTTGATCCCGACATAGT|GATCCTATGTTTGATCCCGACATAGTGGGT
CGACATAGTGGGTACCCGACAAGGCGAACT|AGGAGCTGCGTATCACCGCTGAAACCGCAG
AAATCATGAATCCGCGCGTACGGGGTCGGT|GATCCCGACATAGTGGGTACCCGAAGTCGT
ACACGCTCGACCGTTCAATTATCTTATGTT|GTGGGTACCCGCCGGGTAGCACAGACCTTG
GATCCCGACATAGTGGGTACCCGAAGTCGT|TCCGAAAACGAGTCGACATGGACTCGATAT
AATCAATACGGTTGCTGATAGCTGGCCGTA|TCCCGACATAGTGGGTACCCGTATGTTTGA
TATGTTTGATCCCGACATAGTGGGTACCCG|GAATATGTGGCAGGCGGCAATAATCTCATT
AAGGGGCCTGCCTTTTAGTGCTCTTCATTC|TTTGATCCCGACATAGTGGGTACCCGCCGG
CAATACGGTTGCTGATAGCTGGCCGTATGT|CGACATAGTGGGTACCCGTATGTTTGATCC
CCCGGATCCCGACATAGTGGGTATATGTTT|ATCAAGATAGGCTGAGGGACTTTGATTTCA
GTTTTGATCCAATTACCATACGTATATAGG|AGTGTATGGACTTGTGCAATTTATTGTCTG
TGGGTACCCGCGACATAGTGGGTACCCGTT|CATAGTGGGTACCCGCTTACCGATGGTGGT
TTAAAAGCAGCCCGCCGAGTAAATACTTGC|TTCGACATGTTCTAGGCATCATGGAGAACC
TCCCGACATAGTGGGTACCCGTATGTTTGA|GTATGTATGTTTGATCCTATGTTTGATCCC
CATAGTGGGTACCCGCCGGGACACACAATC|GGCAATAATCTCATTACGCAATGAAGAATC
ACATAGTGGGTACCCGAAGTCGTAAATGAG|ACGAGTCGACATGGACTCGATATCCACAGA
AGTAAATACTTGCTTAACCCCAGCGGAGTG|ATCATGGAGAACCCTCACAGCTATGTTTGA
ATTTATTGTCTGTGTCTTGTAATGGTGAAG|GTACCCGACAAGGCGAACTCTATCTTATAA
TTATAACGCAGAGCTATGTTTGATCCCGAC|AAATAAAGAGATCGGAATATGTGGCAGGCG
GATGGTGGTATAGGCCGCTTGCTATCGAGC|CGGACCTGTATGAATATGTTTTATGTTTGA
CCGTTTGATCCCGACATAGTGGGTACCCGA|GTGGTATAGGCCGCTTGCTATCGAGCAAAA
CCCCAGCGGAGTGTATGGACTTGTGCAATT|CAGCTATGTTTGATCCCGACATAGTGGGTA
TACCCGGATCCCGACATAGTGGGTATATGT|GGATCAAGATAGGCTGAGGGACTTTGATTT
CCGACATAGTGGGTACTATGTTTGATCCCG|CATAGTGGGTACCCGCGACATAGTGGGTAC
GGTACCCGTTGATCCCGACATAGTGGGTAC|CGTACGGGGTCGGTATGTATGTTTGATCCT
CATAGTGGGTACCCGACAAGGCGAACTCTA|AGCTGCGTATCACCGCTGAAACCGCAGGCT
CTGGCCGTATGTTTGATCCCGACATAGTGG|TATGTTTGATCCCGACATAGTGGGTACTAT
GTACCCGCCCGATCTGAGTCGCCCGCTATG|CAGCCCGCCGAGTAAATACTTGCTTAACCC
ATCCCGACATAGTGGGTACCCGCTTACCGA|CTTAAAGCGGTGCCTCTCTGGTTATCTTCG
GGTTCGGCAGTTGGTCCAAAGAATACGTAT|TACCCGCGGCCGAAAACACGCTCGACCGTT
TTTTAGTGCTCTTCATTCGACATGTTCTAG|ATAGTGGGTACCCGCCGGGACACACAATCC
GACATAGTGGGTACCCGCCGGGACACACAA|GCGGCAATAATCTCATTACGCAATGAAGAA
GTTTGATCCTATGTTTGATCCCGACATAGT|GGTGCAGCCATCTTTATGTTTGATCCCGAC
TTGCTTAACCCCAGCGGAGTGTATGGACTT|AACCCTCACAGCTATGTTTGATCCCGACAT
GATCCCGACATAGTGGGTACTATGTTTGAT|CCGACATAGTGGGTACCCGCGACATAGTGG
GGTACCCGCGACATAGTGGGTACCCGTTTG|TAGTGGGTACCCGCTTACCGATGGTGGTAT
GTACCCGTTTGATCCCGACATAGTGGGTAC|GATGGTGGTATAGGCCGCTTGCTATCGAGC
GCCGCTTGCTATCGAGCAAAAATTATTTGA|ATATGTTTTATGTTTGATCCCGACATAGTG
CCATCTTTATGTTTGATCCCGACATAGTGG|TCGCAGCTGCAAATACTTAAAGCGGTGCCT
TATGGACTTGTGCAATTTATTGTCTGTGTC|TCCCGACATAGTGGGTACCCGACAAGGCGA
AGGCCGCTTGCTATCGAGCAAAAATTATTT|GAATATGTTTTATGTTTGATCCCGACATAG
GAAAACACGCTCGACCGTTCAATTATCTTA|CATAGTGGGTACCCGCCGGGTAGCACAGAC
TTGTAATGGTGAAGCTGACTAAAGCAAAGG|ACTCTATCTTATAACGCAGAGCTATGTTTG
TATAACGCAGAGCTATGTTTGATCCCGACA|AATAAAGAGATCGGAATATGTGGCAGGCGG
AAGAATACGTATATTTACAGATAAGCCAAC|CGCTCGACCGTTCAATTATCTTATGTTATG
GACATGTTCTAGGCATCATGGAGAACCCTC|GACACACAATCCACACTGGACGCTTTATCG
CCCGACATAGTGGGTACCCGTATGTTTGAT|TATGTATGTTTGATCCTATGTTTGATCCCG
AGAAAAATCATGAATCCGCGCGTACGGGGT|GTTTGATCCCGACATAGTGGGTACCCGAAG
TGTCTGTGTCTTGTAATGGTGAAGCTGACT|GACAAGGCGAACTCTATCTTATAACGCAGA
CCGATGGTGGTATAGGCCGCTTGCTATCGA|TTCGGACCTGTATGAATATGTTTTATGTTT
AACTCTATCTTATAACGCAGAGCTATGTTT|GCAGGCTTAAAATAAAGAGATCGGAATATG
ATTATTTGACTCCGAAAACGAGTCGACATG|GACATAGTGGGTACCCGGATCCCGACATAG
CATTCGACATGTTCTAGGCATCATGGAGAA|GCCGGGACACACAATCCACACTGGACGCTT
GTACGGGGTCGGTATGTATGTTTGATCCTA|TACCCGAAGTCGTAAATGAGGTGCAGCCAT
GCTATGTTTGATCCCGACATAGTGGGTACC|CGGAATATGTGGCAGGCGGCAATAATCTCA
CAGCTGCAAATACTTAAAGCGGTGCCTCTC|TGGGTACCCGCCCGATCTGAGTCGCCCGCT
GCACAGACCTTGTAGAAAAATCATGAATCC|TACCCGAATGTATGTTTGATCCCGACATAG
CTGCGCTGAATCAATACGGTTGCTGATAGC|CCCGTTGATCCCGACATAGTGGGTACCCGT
CCAAAGAATACGTATATTTACAGATAAGCC|ACACGCTCGACCGTTCAATTATCTTATGTT
GGGTACTATGTTTGATCCCGACATAGTGGG|ACCCGCGACATAGTGGGTACCCGTTTGATC
GATCCCGACATAGTGGGTACCCGCTTACCG|ACTTAAAGCGGTGCCTCTCTGGTTATCTTC
GGTACCCGCCGGGTAGCACAGACCTTGTAG|TCCCGACATAGTGGGTACCCGAATGTATGT
GTTTGATCCCGACATAGTGGGTACCCGGAT|ATAGGCAAAGTGCACATTAGAGGATCAAGA
CGCCGAGTAAATACTTGCTTAACCCCAGCG|TAGGCATCATGGAGAACCCTCACAGCTATG
AGCCATCTTTATGTTTGATCCCGACATAGT|CATCGCAGCTGCAAATACTTAAAGCGGTGC
CTCTCTGGTTATCTTCGGACCTGTATGAAT|CCGCTATGGTTGGAGTTTTGATCCAATTAC
GTTTTATGTTTGATCCCGACATAGTGGGTA|TACGTATATAGGCAAAGTGCACATTAGAGG
CACTGGACGCTTTATCGTCTACGTGCGATC|GCAAAGTTCCCAGACGATCAGCCACCAAGC
TCTTCGGACCTGTATGAATATGTTTTATGT|GGAGTTTTGATCCAATTACCATACGTATAT
ATATGTTTTATGTTTGATCCCGACATAGTG|ACCATACGTATATAGGCAAAGTGCACATTA
TTTGATCCCGACATAGTGGGTACCCGAAGT|GACTCCGAAAACGAGTCGACATGGACTCGA
TCACCGCTGAAACCGCAGGCTTAAAATAAA|TTGTTACTGAACACGAACAGAACACTCCTC
ACCCGCGGCCGAAAACACGCTCGACCGTTC|TTGATCCCGACATAGTGGGTACCCGCCGGG
GACCACCATCGCAGCTGCAAATACTTAAAG|TCCCGACATAGTGGGTACCCGCCCGATCTG
AAGTGCACATTAGAGGATCAAGATAGGCTG|TCTTGTAATGGTGAAGCTGACTAAAGCAAA
ATTTCATAAAAATAATTAAAAGCAGCCCGC|TTTTAGTGCTCTTCATTCGACATGTTCTAG
AACGAGTCGACATGGACTCGATATCCACAG|GGATCCCGACATAGTGGGTATATGTTTGAT
CCAACCTGCCCAACTGGAAAAGCGCAACTG|TTATGTTTGATCCCGACATAGTGGGTACCC
GAGCTATGTTTGATCCCGACATAGTGGGTA|ATCGGAATATGTGGCAGGCGGCAATAATCT
GGGTACCCGAATGTATGTTTGATCCCGACA|TCGAGCAAAAATTATTTGACTCCGAAAACG
ATCGTCTACGTGCGATCCCGGAGGAGCTGC|ACGATCAGCCACCAAGCGGGTGGGTCAGCG
GAGTAAATACTTGCTTAACCCCAGCGGAGT|CATCATGGAGAACCCTCACAGCTATGTTTG
CTTGCAAAGTTCCCAGACGATCAGCCACCA|ATGCTTTGAGCTTTTTACTCTGGCAAATTG
GATCCCGACATAGTGGGTACCCGAATGTAT|TAGGCCGCTTGCTATCGAGCAAAAATTATT
TACGTATATAGGCAAAGTGCACATTAGAGG|ATTTATTGTCTGTGTCTTGTAATGGTGAAG
AGCGCAACTGCGCTGAATCAATACGGTTGC|GTGGGTACCCGTTGATCCCGACATAGTGGG
AATTAAAAGCAGCCCGCCGAGTAAATACTT|CATTCGACATGTTCTAGGCATCATGGAGAA
ATAGGCTGAGGGACTTTGATTTCATAAAAA|AAAGCAAAGGGGCCTGCCTTTTAGTGCTCT
TAACCCCAGCGGAGTGTATGGACTTGTGCA|TCACAGCTATGTTTGATCCCGACATAGTGG
TATTTGACTCCGAAAACGAGTCGACATGGA|CATAGTGGGTACCCGGATCCCGACATAGTG
GCTGACTAAAGCAAAGGGGCCTGCCTTTTA|ACGCAGAGCTATGTTTGATCCCGACATAGT
ACATAGTGGGTACCCGTTGATCCCGACATA|AATCCGCGCGTACGGGGTCGGTATGTATGT
CCGACATAGTGGGTACCCGCCCGATCTGAG|AATAATTAAAAGCAGCCCGCCGAGTAAATA
GATCCCGACATAGTGGGTACCCGCCGGGTA|TGGGTACCCGTTTGATCCCGACATAGTGGG
TAGTGCTCTTCATTCGACATGTTCTAGGCA|GTGGGTACCCGCCGGGACACACAATCCACA
GTGGCAGGCGGCAATAATCTCATTACGCAA|AGAGGCTTGCACTTGTCACCTAACTACTGA
TGGAGTTTTGATCCAATTACCATACGTATA|GCGGAGTGTATGGACTTGTGCAATTTATTG
ACTGGAAAAGCGCAACTGCGCTGAATCAAT|CCGACATAGTGGGTACCCGTTGATCCCGAC
AGATAAGCCAACCTGCCCAACTGGAAAAGC|TCTTATGTTATGTTTGATCCCGACATAGTG
CCTCACAGCTATGTTTGATCCCGACATAGT|ATCGTCTACGTGCGATCCCGGAGGAGCTGC
ATCCCGGAGGAGCTGCGTATCACCGCTGAA|AGCGGGTGGGTCAGCGTAGTTGTTACTGAA
GTATATTTACAGATAAGCCAACCTGCCCAA|CGTTCAATTATCTTATGTTATGTTTGATCC
TTATCGTCTACGTGCGATCCCGGAGGAGCT|AGACGATCAGCCACCAAGCGGGTGGGTCAG
GGAAAAGCGCAACTGCGCTGAATCAATACG|ACATAGTGGGTACCCGTTGATCCCGACATA
TTGATCCCGACATAGTGGGTACCCGTTGAT|AAAATCATGAATCCGCGCGTACGGGGTCGG
TTTCATAAAAATAATTAAAAGCAGCCCGCC|TTTAGTGCTCTTCATTCGACATGTTCTAGG
TGAGTCGCCCGCTATGGTTGGAGTTTTGAT|AATACTTGCTTAACCCCAGCGGAGTGTATG
TGATCCCGACATAGTGGGTACCCGCGACAT|ATGTTTGATCCCGACATAGTGGGTACCCGC
TTGTGCAATTTATTGTCTGTGTCTTGTAAT|ATAGTGGGTACCCGACAAGGCGAACTCTAT
TTTGATCCAATTACCATACGTATATAGGCA|TGTATGGACTTGTGCAATTTATTGTCTGTG
GGCAAAGTGCACATTAGAGGATCAAGATAG|TGTGTCTTGTAATGGTGAAGCTGACTAAAG
GGCATCATGGAGAACCCTCACAGCTATGTT|CACACTGGACGCTTTATCGTCTACGTGCGA
AGCGGAGTGTATGGACTTGTGCAATTTATT|TATGTTTGATCCCGACATAGTGGGTACCCG
GCAGCCCGCCGAGTAAATACTTGCTTAACC|ATGTTCTAGGCATCATGGAGAACCCTCACA
ACATAGTGGGTACCCGCCCGATCTGAGTCG|AATTAAAAGCAGCCCGCCGAGTAAATACTT
TATGTTTGATCCCGACATAGTGGGTACCCG|GTAGAAAAATCATGAATCCGCGCGTACGGG
AATACTTAAAGCGGTGCCTCTCTGGTTATC|CGCCCGATCTGAGTCGCCCGCTATGGTTGG
AAAGTTCCCAGACGATCAGCCACCAAGCGG|TTGAGCTTTTTACTCTGGCAAATTGTTTCA
GTATGTTTGATCCCGACATAGTGGGTACCC|TATTTGACTCCGAAAACGAGTCGACATGGA
TGGTGGTATAGGCCGCTTGCTATCGAGCAA|GACCTGTATGAATATGTTTTATGTTTGATC
TAGTGGGTACCCGCGGCCGAAAACACGCTC|TACTATGTTTGATCCCGACATAGTGGGTAC
ATGTTTGATCCCGACATAGTGGGTACCCGT|TAGAAAAATCATGAATCCGCGCGTACGGGG
TTGATCCAATTACCATACGTATATAGGCAA|GTATGGACTTGTGCAATTTATTGTCTGTGT
CCCGACATAGTGGGTACCCGCGACATAGTG|TTGATCCCGACATAGTGGGTACCCGCTTAC
ACCCTCACAGCTATGTTTGATCCCGACATA|TTATCGTCTACGTGCGATCCCGGAGGAGCT
TCCCGGAGGAGCTGCGTATCACCGCTGAAA|GCGGGTGGGTCAGCGTAGTTGTTACTGAAC
GCAATTTATTGTCTGTGTCTTGTAATGGTG|TGGGTACCCGACAAGGCGAACTCTATCTTA
ACATAGTGGGTACCCGACAAGGCGAACTCT|GAGCTGCGTATCACCGCTGAAACCGCAGGC
ACTTAAAGCGGTGCCTCTCTGGTTATCTTC|CCGATCTGAGTCGCCCGCTATGGTTGGAGT
GCGGCAATAATCTCATTACGCAATGAAGAA|TGCACTTGTCACCTAACTACTGAGCGCATA
GTTGCTGATAGCTGGCCGTATGTTTGATCC|GTGGGTACCCGTATGTTTGATCCCGACATA
GTTCTAGGCATCATGGAGAACCCTCACAGC|ACAATCCACACTGGACGCTTTATCGTCTAC
ATAGTGGGTACCCGACAAGGCGAACTCTAT|GCTGCGTATCACCGCTGAAACCGCAGGCTT
GTAAATACTTGCTTAACCCCAGCGGAGTGT|TCATGGAGAACCCTCACAGCTATGTTTGAT
TAAAATAAAGAGATCGGAATATGTGGCAGG|ACACTCCTCAAGTTAGCATGGCAGAGGCTT
TGTATGTTTGATCCTATGTTTGATCCCGAC|AATGAGGTGCAGCCATCTTTATGTTTGATC
GTGGGTACCCGCGGCCGAAAACACGCTCGA|CTATGTTTGATCCCGACATAGTGGGTACCC
AGACCACCATCGCAGCTGCAAATACTTAAA|ATCCCGACATAGTGGGTACCCGCCCGATCT
GAAACCGCAGGCTTAAAATAAAGAGATCGG|GAACACGAACAGAACACTCCTCAAGTTAGC
CGTATGTTTGATCCCGACATAGTGGGTACC|TTGATCCCGACATAGTGGGTACTATGTTTG
CGAGTCGACATGGACTCGATATCCACAGAC|ATCCCGACATAGTGGGTATATGTTTGATCC
CCCGACATAGTGGGTACCCGCCGGGACACA|CAGGCGGCAATAATCTCATTACGCAATGAA
TGATCCCGACATAGTGGGTACCCGCTTACC|TACTTAAAGCGGTGCCTCTCTGGTTATCTT
CAGACCTTGTAGAAAAATCATGAATCCGCG|CCGAATGTATGTTTGATCCCGACATAGTGG
GATCCCGACATAGTGGGTATATGTTTGATC|AGATAGGCTGAGGGACTTTGATTTCATAAA
ATCCCGACATAGTGGGTACCCGCGGCCGAA|CATAGTGGGTACTATGTTTGATCCCGACAT
TGAAACCGCAGGCTTAAAATAAAGAGATCG|TGAACACGAACAGAACACTCCTCAAGTTAG
TTGTCTGTGTCTTGTAATGGTGAAGCTGAC|CGACAAGGCGAACTCTATCTTATAACGCAG
GGTACCCGCCCGATCTGAGTCGCCCGCTAT|GCAGCCCGCCGAGTAAATACTTGCTTAACC
AAGAATCTTGCAAAGTTCCCAGACGATCAG|GCATACATGCTTTGAGCTTTTTACTCTGGC
AAGAGATCGGAATATGTGGCAGGCGGCAAT|TCAAGTTAGCATGGCAGAGGCTTGCACTTG
GCAGTTGGTCCAAAGAATACGTATATTTAC|CGGCCGAAAACACGCTCGACCGTTCAATTA
GTTATCTTCGGACCTGTATGAATATGTTTT|GGTTGGAGTTTTGATCCAATTACCATACGT
ATCCCGACATAGTGGGTACCCGCGACATAG|GTTTGATCCCGACATAGTGGGTACCCGCTT
CCGAATGTATGTTTGATCCCGACATAGTGG|AAAAATTATTTGACTCCGAAAACGAGTCGA
TCTGGTTATCTTCGGACCTGTATGAATATG|CTATGGTTGGAGTTTTGATCCAATTACCAT
TATGTTTGATCCCGACATAGTGGGTACCCG|GATCCCGACATAGTGGGTACTATGTTTGAT
CAGACCACCATCGCAGCTGCAAATACTTAA|GATCCCGACATAGTGGGTACCCGCCCGATC
GTCCAAAGAATACGTATATTTACAGATAAG|AAACACGCTCGACCGTTCAATTATCTTATG
TTAAAATAAAGAGATCGGAATATGTGGCAG|AACACTCCTCAAGTTAGCATGGCAGAGGCT
TGCTTAACCCCAGCGGAGTGTATGGACTTG|ACCCTCACAGCTATGTTTGATCCCGACATA
CCCGACATAGTGGGTACCCGAAGTCGTAAA|GAAAACGAGTCGACATGGACTCGATATCCA
ATATGTGGCAGGCGGCAATAATCTCATTAC|TGGCAGAGGCTTGCACTTGTCACCTAACTA
TTCAATTATCTTATGTTATGTTTGATCCCG|GGGTAGCACAGACCTTGTAGAAAAATCATG
GCAGAGCTATGTTTGATCCCGACATAGTGG|GAGATCGGAATATGTGGCAGGCGGCAATAA
CTATCTTATAACGCAGAGCTATGTTTGATC|GCTTAAAATAAAGAGATCGGAATATGTGGC
GTGTCTTGTAATGGTGAAGCTGACTAAAGC|GGCGAACTCTATCTTATAACGCAGAGCTAT
TGTTTGATCCCGACATAGTGGGTACCCGCT|CAAATACTTAAAGCGGTGCCTCTCTGGTTA
ACGCAATGAAGAATCTTGCAAAGTTCCCAG|TACTGAGCGCATACATGCTTTGAGCTTTTT
AATCTCATTACGCAATGAAGAATCTTGCAA|TCACCTAACTACTGAGCGCATACATGCTTT
CTGTATGAATATGTTTTATGTTTGATCCCG|ATCCAATTACCATACGTATATAGGCAAAGT
ACATAGTGGGTACCCGTATGTTTGATCCCG|TATGTTTGATCCTATGTTTGATCCCGACAT
ACCATCGCAGCTGCAAATACTTAAAGCGGT|GACATAGTGGGTACCCGCCCGATCTGAGTC
CGCTTTATCGTCTACGTGCGATCCCGGAGG|TCCCAGACGATCAGCCACCAAGCGGGTGGG
ATGTATGTTTGATCCCGACATAGTGGGTAC|ATTATTTGACTCCGAAAACGAGTCGACATG
TGTTTGATCCCGACATAGTGGGTACCCGCG|TCCCGACATAGTGGGTACTATGTTTGATCC
ACAGACCACCATCGCAGCTGCAAATACTTA|TGATCCCGACATAGTGGGTACCCGCCCGAT
GGTCGGTATGTATGTTTGATCCTATGTTTG|AAGTCGTAAATGAGGTGCAGCCATCTTTAT
TGATCCCGACATAGTGGGTACCCGAAGTCG|CTCCGAAAACGAGTCGACATGGACTCGATA
TAACGCAGAGCTATGTTTGATCCCGACATA|TAAAGAGATCGGAATATGTGGCAGGCGGCA
ACCTGTATGAATATGTTTTATGTTTGATCC|TGATCCAATTACCATACGTATATAGGCAAA
TTTATGTTTGATCCCGACATAGTGGGTACC|CGTATATAGGCAAAGTGCACATTAGAGGAT
GGTACTATGTTTGATCCCGACATAGTGGGT|CCCGCGACATAGTGGGTACCCGTTTGATCC
GATCCTATGTTTGATCCCGACATAGTGGGT|CAGCCATCTTTATGTTTGATCCCGACATAG
GGTCCAAAGAATACGTATATTTACAGATAA|AAAACACGCTCGACCGTTCAATTATCTTAT
TTGTAGAAAAATCATGAATCCGCGCGTACG|GTATGTTTGATCCCGACATAGTGGGTACCC
GTACCCGGATCCCGACATAGTGGGTATATG|AGGATCAAGATAGGCTGAGGGACTTTGATT
TCATAAAAATAATTAAAAGCAGCCCGCCGA|TAGTGCTCTTCATTCGACATGTTCTAGGCA
GGGTACCCGCTTACCGATGGTGGTATAGGC|CTCTCTGGTTATCTTCGGACCTGTATGAAT
CAATAATCTCATTACGCAATGAAGAATCTT|CTTGTCACCTAACTACTGAGCGCATACATG
AAGCCAACCTGCCCAACTGGAAAAGCGCAA|ATGTTATGTTTGATCCCGACATAGTGGGTA
GTAGAAAAATCATGAATCCGCGCGTACGGG|ATGTTTGATCCCGACATAGTGGGTACCCGA
CCCAGACGATCAGCCACCAAGCGGGTGGGT|TTTTTACTCTGGCAAATTGTTTCAAAATTG
TATCCACAGACCACCATCGCAGCTGCAAAT|ATGTTTGATCCCGACATAGTGGGTACCCGC
GGGTACCCGACAAGGCGAACTCTATCTTAT|GTATCACCGCTGAAACCGCAGGCTTAAAAT
GGGTCGGTATGTATGTTTGATCCTATGTTT|GAAGTCGTAAATGAGGTGCAGCCATCTTTA
AGTCGACATGGACTCGATATCCACAGACCA|CCCGACATAGTGGGTATATGTTTGATCCCG
TAGTGGGTACCCGTTTGATCCCGACATAGT|CTTACCGATGGTGGTATAGGCCGCTTGCTA
TCCTATGTTTGATCCCGACATAGTGGGTAC|GCCATCTTTATGTTTGATCCCGACATAGTG
CGGGGTCGGTATGTATGTTTGATCCTATGT|CCGAAGTCGTAAATGAGGTGCAGCCATCTT
CGGAATATGTGGCAGGCGGCAATAATCTCA|AGCATGGCAGAGGCTTGCACTTGTCACCTA
GGTGAAGCTGACTAAAGCAAAGGGGCCTGC|CTTATAACGCAGAGCTATGTTTGATCCCGA
GTGGGTACCCGTTTGATCCCGACATAGTGG|TACCGATGGTGGTATAGGCCGCTTGCTATC
ATATGTTTGATCCCGACATAGTGGGTACCC|TGATTTCATAAAAATAATTAAAAGCAGCCC
AATAATTAAAAGCAGCCCGCCGAGTAAATA|CTTCATTCGACATGTTCTAGGCATCATGGA
GCAGGCTTAAAATAAAGAGATCGGAATATG|GAACAGAACACTCCTCAAGTTAGCATGGCA
TCCAAAGAATACGTATATTTACAGATAAGC|AACACGCTCGACCGTTCAATTATCTTATGT
GACGATCAGCCACCAAGCGGGTGGGTCAGC|TACTCTGGCAAATTGTTTCAAAATTGCGCG
GCTTAACCCCAGCGGAGTGTATGGACTTGT|CCCTCACAGCTATGTTTGATCCCGACATAG
CATAGTGGGTACCCGCGGCCGAAAACACGC|GGTACTATGTTTGATCCCGACATAGTGGGT
GCGCAACTGCGCTGAATCAATACGGTTGCT|TGGGTACCCGTTGATCCCGACATAGTGGGT
CGATGGTGGTATAGGCCGCTTGCTATCGAG|TCGGACCTGTATGAATATGTTTTATGTTTG
TGTTTGATCCCGACATAGTGGGTACCCGAC|GCGATCCCGGAGGAGCTGCGTATCACCGCT
ACCATACGTATATAGGCAAAGTGCACATTA|TGCAATTTATTGTCTGTGTCTTGTAATGGT
TTATTGTCTGTGTCTTGTAATGGTGAAGCT|ACCCGACAAGGCGAACTCTATCTTATAACG
ATACTTGCTTAACCCCAGCGGAGTGTATGG|GGAGAACCCTCACAGCTATGTTTGATCCCG
TACCCGAAGTCGTAAATGAGGTGCAGCCAT|ATGGACTCGATATCCACAGACCACCATCGC
AATATGTTTTATGTTTGATCCCGACATAGT|TACCATACGTATATAGGCAAAGTGCACATT
AATGAAGAATCTTGCAAAGTTCCCAGACGA|GAGCGCATACATGCTTTGAGCTTTTTACTC
GAGGATCAAGATAGGCTGAGGGACTTTGAT|GAAGCTGACTAAAGCAAAGGGGCCTGCCTT
GCCGGGTAGCACAGACCTTGTAGAAAAATC|ATAGTGGGTACCCGAATGTATGTTTGATCC
GCAAAGTGCACATTAGAGGATCAAGATAGG|GTGTCTTGTAATGGTGAAGCTGACTAAAGC
CTATCGAGCAAAAATTATTTGACTCCGAAA|TATGTTTGATCCCGACATAGTGGGTACCCG
GTGGTATAGGCCGCTTGCTATCGAGCAAAA|CCTGTATGAATATGTTTTATGTTTGATCCC
AAAGCAAAGGGGCCTGCCTTTTAGTGCTCT|GCTATGTTTGATCCCGACATAGTGGGTACC
TGTTTTATGTTTGATCCCGACATAGTGGGT|ATACGTATATAGGCAAAGTGCACATTAGAG
GGACCTGTATGAATATGTTTTATGTTTGAT|TTTGATCCAATTACCATACGTATATAGGCA
CCGCCGGGTAGCACAGACCTTGTAGAAAAA|ACATAGTGGGTACCCGAATGTATGTTTGAT
AGGATCAAGATAGGCTGAGGGACTTTGATT|AAGCTGACTAAAGCAAAGGGGCCTGCCTTT
TATATGTTTGATCCCGACATAGTGGGTACC|TTGATTTCATAAAAATAATTAAAAGCAGCC
GGCCGAAAACACGCTCGACCGTTCAATTAT|CCGACATAGTGGGTACCCGCCGGGTAGCAC
CAATTACCATACGTATATAGGCAAAGTGCA|ACTTGTGCAATTTATTGTCTGTGTCTTGTA
TACGGGGTCGGTATGTATGTTTGATCCTAT|ACCCGAAGTCGTAAATGAGGTGCAGCCATC
GACATAGTGGGTATATGTTTGATCCCGACA|GCTGAGGGACTTTGATTTCATAAAAATAAT
AATGTATGTTTGATCCCGACATAGTGGGTA|AATTATTTGACTCCGAAAACGAGTCGACAT
GGACTTTGATTTCATAAAAATAATTAAAAG|GGCCTGCCTTTTAGTGCTCTTCATTCGACA
TCTTCATTCGACATGTTCTAGGCATCATGG|ACCCGCCGGGACACACAATCCACACTGGAC
GACCTTGTAGAAAAATCATGAATCCGCGCG|GAATGTATGTTTGATCCCGACATAGTGGGT
CATAGTGGGTACCCGTTTGATCCCGACATA|CGCTTACCGATGGTGGTATAGGCCGCTTGC
ACTTGTGCAATTTATTGTCTGTGTCTTGTA|ACATAGTGGGTACCCGACAAGGCGAACTCT
ATCTTGCAAAGTTCCCAGACGATCAGCCAC|ACATGCTTTGAGCTTTTTACTCTGGCAAAT
GTACCCGACAAGGCGAACTCTATCTTATAA|ATCACCGCTGAAACCGCAGGCTTAAAATAA
TATAGGCAAAGTGCACATTAGAGGATCAAG|TGTCTGTGTCTTGTAATGGTGAAGCTGACT
GACTCCGAAAACGAGTCGACATGGACTCGA|TGGGTACCCGGATCCCGACATAGTGGGTAT
CCAGACGATCAGCCACCAAGCGGGTGGGTC|TTTTACTCTGGCAAATTGTTTCAAAATTGC
GAAGAATCTTGCAAAGTTCCCAGACGATCA|CGCATACATGCTTTGAGCTTTTTACTCTGG
TGTTTGATCCCGACATAGTGGGTACTATGT|TGATCCCGACATAGTGGGTACCCGCGACAT
TTTGATTTCATAAAAATAATTAAAAGCAGC|TGCCTTTTAGTGCTCTTCATTCGACATGTT
TAGTGGGTACCCGAATGTATGTTTGATCCC|GCTATCGAGCAAAAATTATTTGACTCCGAA
GCGGCCGAAAACACGCTCGACCGTTCAATT|TCCCGACATAGTGGGTACCCGCCGGGTAGC
ATCCCGACATAGTGGGTACCCGTATGTTTG|GGTATGTATGTTTGATCCTATGTTTGATCC
TACAGATAAGCCAACCTGCCCAACTGGAAA|TTATCTTATGTTATGTTTGATCCCGACATA
ACCGATGGTGGTATAGGCCGCTTGCTATCG|CTTCGGACCTGTATGAATATGTTTTATGTT
AATACGTATATTTACAGATAAGCCAACCTG|TCGACCGTTCAATTATCTTATGTTATGTTT
CGCGGCCGAAAACACGCTCGACCGTTCAAT|ATCCCGACATAGTGGGTACCCGCCGGGTAG
GTTGGAGTTTTGATCCAATTACCATACGTA|CAGCGGAGTGTATGGACTTGTGCAATTTAT
GAATATGTTTTATGTTTGATCCCGACATAG|TTACCATACGTATATAGGCAAAGTGCACAT
CTATGTTTGATCCCGACATAGTGGGTACCC|CGTGCGATCCCGGAGGAGCTGCGTATCACC
ATCCCGACATAGTGGGTACCCGTTGATCCC|ATCATGAATCCGCGCGTACGGGGTCGGTAT
CCCGCGGCCGAAAACACGCTCGACCGTTCA|TGATCCCGACATAGTGGGTACCCGCCGGGT
TACGTGCGATCCCGGAGGAGCTGCGTATCA|AGCCACCAAGCGGGTGGGTCAGCGTAGTTG
GTTTGATCCCGACATAGTGGGTACCCGCCG|ATAGTGGGTACCCGTTTGATCCCGACATAG
ATCCCGACATAGTGGGTACCCGCCGGGACA|GGCAGGCGGCAATAATCTCATTACGCAATG
AGCACAGACCTTGTAGAAAAATCATGAATC|GTACCCGAATGTATGTTTGATCCCGACATA
CCGACATAGTGGGTACCCGCCGGGACACAC|AGGCGGCAATAATCTCATTACGCAATGAAG
TTTTATGTTTGATCCCGACATAGTGGGTAC|ACGTATATAGGCAAAGTGCACATTAGAGGA
CAGCGGAGTGTATGGACTTGTGCAATTTAT|CTATGTTTGATCCCGACATAGTGGGTACCC
CTGGACGCTTTATCGTCTACGTGCGATCCC|AAAGTTCCCAGACGATCAGCCACCAAGCGG
TAAGCCAACCTGCCCAACTGGAAAAGCGCA|TATGTTATGTTTGATCCCGACATAGTGGGT
AGTGGGTACCCGGATCCCGACATAGTGGGT|ATTAGAGGATCAAGATAGGCTGAGGGACTT
GACTCGATATCCACAGACCACCATCGCAGC|TGGGTATATGTTTGATCCCGACATAGTGGG
AAATACTTGCTTAACCCCAGCGGAGTGTAT|ATGGAGAACCCTCACAGCTATGTTTGATCC
CCTGCCCAACTGGAAAAGCGCAACTGCGCT|GTTTGATCCCGACATAGTGGGTACCCGTTG
GAGTCGCCCGCTATGGTTGGAGTTTTGATC|ATACTTGCTTAACCCCAGCGGAGTGTATGG
CCAATTACCATACGTATATAGGCAAAGTGC|GACTTGTGCAATTTATTGTCTGTGTCTTGT
TATCACCGCTGAAACCGCAGGCTTAAAATA|AGTTGTTACTGAACACGAACAGAACACTCC
ATGTTTGATCCCGACATAGTGGGTACCCGC|ATCCCGACATAGTGGGTACTATGTTTGATC
AAAACACGCTCGACCGTTCAATTATCTTAT|ATAGTGGGTACCCGCCGGGTAGCACAGACC
TAGAGGATCAAGATAGGCTGAGGGACTTTG|GTGAAGCTGACTAAAGCAAAGGGGCCTGCC
AGGTGCAGCCATCTTTATGTTTGATCCCGA|GACCACCATCGCAGCTGCAAATACTTAAAG
CTTACCGATGGTGGTATAGGCCGCTTGCTA|TATCTTCGGACCTGTATGAATATGTTTTAT
AGCGGTGCCTCTCTGGTTATCTTCGGACCT|TGAGTCGCCCGCTATGGTTGGAGTTTTGAT
CCGACATAGTGGGTACCCGACAAGGCGAAC|GAGGAGCTGCGTATCACCGCTGAAACCGCA
ATAGCTGGCCGTATGTTTGATCCCGACATA|CCCGTATGTTTGATCCCGACATAGTGGGTA
GTACCCGCCGGGTAGCACAGACCTTGTAGA|CCCGACATAGTGGGTACCCGAATGTATGTT
ACCCGCCCGATCTGAGTCGCCCGCTATGGT|GCCCGCCGAGTAAATACTTGCTTAACCCCA
GCAACTGCGCTGAATCAATACGGTTGCTGA|GGTACCCGTTGATCCCGACATAGTGGGTAC
GCGAACTCTATCTTATAACGCAGAGCTATG|ACCGCAGGCTTAAAATAAAGAGATCGGAAT
AATGAGGTGCAGCCATCTTTATGTTTGATC|CACAGACCACCATCGCAGCTGCAAATACTT
AGTGGGTACCCGCTTACCGATGGTGGTATA|TGCCTCTCTGGTTATCTTCGGACCTGTATG
TTTTGATCCAATTACCATACGTATATAGGC|GTGTATGGACTTGTGCAATTTATTGTCTGT
AGGAGCTGCGTATCACCGCTGAAACCGCAG|GGGTCAGCGTAGTTGTTACTGAACACGAAC
TATGTTTGATCCCGACATAGTGGGTACCCG|GACATAGTGGGTACCCGTTTGATCCCGACA
CCCGACATAGTGGGTACCCGACAAGGCGAA|GGAGGAGCTGCGTATCACCGCTGAAACCGC
CGCCGGGTAGCACAGACCTTGTAGAAAAAT|CATAGTGGGTACCCGAATGTATGTTTGATC
ACTCGATATCCACAGACCACCATCGCAGCT|GGGTATATGTTTGATCCCGACATAGTGGGT
GTTTGATCCCGACATAGTGGGTACCCGCGG|CCCGACATAGTGGGTACTATGTTTGATCCC
AAGCGGTGCCTCTCTGGTTATCTTCGGACC|CTGAGTCGCCCGCTATGGTTGGAGTTTTGA
CTATGTTTGATCCCGACATAGTGGGTACCC|CATCTTTATGTTTGATCCCGACATAGTGGG
CGCGTACGGGGTCGGTATGTATGTTTGATC|GGGTACCCGAAGTCGTAAATGAGGTGCAGC
CCCGAAGTCGTAAATGAGGTGCAGCCATCT|GGACTCGATATCCACAGACCACCATCGCAG
CTTTATGTTTGATCCCGACATAGTGGGTAC|AGCTGCAAATACTTAAAGCGGTGCCTCTCT
CGCTGAAACCGCAGGCTTAAAATAAAGAGA|TACTGAACACGAACAGAACACTCCTCAAGT
GTGGGTACCCGAATGTATGTTTGATCCCGA|TATCGAGCAAAAATTATTTGACTCCGAAAA
GTGAAGCTGACTAAAGCAAAGGGGCCTGCC|TTATAACGCAGAGCTATGTTTGATCCCGAC
AGCTGCGTATCACCGCTGAAACCGCAGGCT|TCAGCGTAGTTGTTACTGAACACGAACAGA
CGACATAGTGGGTACCCGAAGTCGTAAATG|AAACGAGTCGACATGGACTCGATATCCACA
TTGATCCTATGTTTGATCCCGACATAGTGG|TGCAGCCATCTTTATGTTTGATCCCGACAT
TCGTCTACGTGCGATCCCGGAGGAGCTGCG|CGATCAGCCACCAAGCGGGTGGGTCAGCGT
GGGTACCCGCCCGATCTGAGTCGCCCGCTA|AGCAGCCCGCCGAGTAAATACTTGCTTAAC
GACGCTTTATCGTCTACGTGCGATCCCGGA|GTTCCCAGACGATCAGCCACCAAGCGGGTG
AATCCACACTGGACGCTTTATCGTCTACGT|AATCTTGCAAAGTTCCCAGACGATCAGCCA
TACTTGCTTAACCCCAGCGGAGTGTATGGA|GAGAACCCTCACAGCTATGTTTGATCCCGA
ATAGTGGGTACTATGTTTGATCCCGACATA|TGGGTACCCGCGACATAGTGGGTACCCGTT
CGCGACATAGTGGGTACCCGTTTGATCCCG|GTACCCGCTTACCGATGGTGGTATAGGCCG
CTCTTCATTCGACATGTTCTAGGCATCATG|TACCCGCCGGGACACACAATCCACACTGGA
CCCGACAAGGCGAACTCTATCTTATAACGC|ACCGCTGAAACCGCAGGCTTAAAATAAAGA
AATACGGTTGCTGATAGCTGGCCGTATGTT|GACATAGTGGGTACCCGTATGTTTGATCCC
GTGGGTACCCGCTTACCGATGGTGGTATAG|GCCTCTCTGGTTATCTTCGGACCTGTATGA
CATGTTCTAGGCATCATGGAGAACCCTCAC|CACACAATCCACACTGGACGCTTTATCGTC
TATATTTACAGATAAGCCAACCTGCCCAAC|GTTCAATTATCTTATGTTATGTTTGATCCC
AACTGGAAAAGCGCAACTGCGCTGAATCAA|CCCGACATAGTGGGTACCCGTTGATCCCGA
GTACCCGCTTACCGATGGTGGTATAGGCCG|CTCTGGTTATCTTCGGACCTGTATGAATAT
TCGTAAATGAGGTGCAGCCATCTTTATGTT|ATATCCACAGACCACCATCGCAGCTGCAAA
CGCCCGATCTGAGTCGCCCGCTATGGTTGG|CGCCGAGTAAATACTTGCTTAACCCCAGCG
CTGCCTTTTAGTGCTCTTCATTCGACATGT|CCGACATAGTGGGTACCCGCCGGGACACAC
TTGATCCCGACATAGTGGGTACCCGTATGT|GTCGGTATGTATGTTTGATCCTATGTTTGA
TACCCGTATGTTTGATCCCGACATAGTGGG|CCTATGTTTGATCCCGACATAGTGGGTACC
GTTCAATTATCTTATGTTATGTTTGATCCC|CGGGTAGCACAGACCTTGTAGAAAAATCAT
GCTGAAACCGCAGGCTTAAAATAAAGAGAT|ACTGAACACGAACAGAACACTCCTCAAGTT
CGCTGAATCAATACGGTTGCTGATAGCTGG|GTTGATCCCGACATAGTGGGTACCCGTATG
TGGAAAAGCGCAACTGCGCTGAATCAATAC|GACATAGTGGGTACCCGTTGATCCCGACAT
AATATGTGGCAGGCGGCAATAATCTCATTA|ATGGCAGAGGCTTGCACTTGTCACCTAACT
GCCTCTCTGGTTATCTTCGGACCTGTATGA|GCCCGCTATGGTTGGAGTTTTGATCCAATT
TAGTGGGTACCCGGATCCCGACATAGTGGG|CATTAGAGGATCAAGATAGGCTGAGGGACT
GGACACACAATCCACACTGGACGCTTTATC|CAATGAAGAATCTTGCAAAGTTCCCAGACG
GGGTACCCGCCGGGACACACAATCCACACT|AATCTCATTACGCAATGAAGAATCTTGCAA
ATCAATACGGTTGCTGATAGCTGGCCGTAT|CCCGACATAGTGGGTACCCGTATGTTTGAT
GTTTGATCCCGACATAGTGGGTACCCGACA|CGATCCCGGAGGAGCTGCGTATCACCGCTG
AGTGTATGGACTTGTGCAATTTATTGTCTG|TTGATCCCGACATAGTGGGTACCCGACAAG
ACTTGCTTAACCCCAGCGGAGTGTATGGAC|AGAACCCTCACAGCTATGTTTGATCCCGAC
TTGATCCCGACATAGTGGGTACTATGTTTG|TCCCGACATAGTGGGTACCCGCGACATAGT
CAACTGCGCTGAATCAATACGGTTGCTGAT|GTACCCGTTGATCCCGACATAGTGGGTACC
TCATTCGACATGTTCTAGGCATCATGGAGA|CGCCGGGACACACAATCCACACTGGACGCT
CGGAGTGTATGGACTTGTGCAATTTATTGT|TGTTTGATCCCGACATAGTGGGTACCCGAC
CTGAAACCGCAGGCTTAAAATAAAGAGATC|CTGAACACGAACAGAACACTCCTCAAGTTA
ATCCTATGTTTGATCCCGACATAGTGGGTA|AGCCATCTTTATGTTTGATCCCGACATAGT
GGTACCCGCTTACCGATGGTGGTATAGGCC|TCTCTGGTTATCTTCGGACCTGTATGAATA
TTACAGATAAGCCAACCTGCCCAACTGGAA|ATTATCTTATGTTATGTTTGATCCCGACAT
ATTAGAGGATCAAGATAGGCTGAGGGACTT|TGGTGAAGCTGACTAAAGCAAAGGGGCCTG
GGTACCCGAATGTATGTTTGATCCCGACAT|CGAGCAAAAATTATTTGACTCCGAAAACGA
AGTGGGTACCCGTATGTTTGATCCCGACAT|TTTGATCCTATGTTTGATCCCGACATAGTG
CTGATAGCTGGCCGTATGTTTGATCCCGAC|GTACCCGTATGTTTGATCCCGACATAGTGG
TCTTTATGTTTGATCCCGACATAGTGGGTA|CAGCTGCAAATACTTAAAGCGGTGCCTCTC
TATCTTCGGACCTGTATGAATATGTTTTAT|TTGGAGTTTTGATCCAATTACCATACGTAT
AGCCCGCCGAGTAAATACTTGCTTAACCCC|GTTCTAGGCATCATGGAGAACCCTCACAGC
GTAATGGTGAAGCTGACTAAAGCAAAGGGG|TCTATCTTATAACGCAGAGCTATGTTTGAT
TGGGTACCCGTTTGATCCCGACATAGTGGG|ACCGATGGTGGTATAGGCCGCTTGCTATCG
ACCTTGTAGAAAAATCATGAATCCGCGCGT|AATGTATGTTTGATCCCGACATAGTGGGTA
GGTACCCGACAAGGCGAACTCTATCTTATA|TATCACCGCTGAAACCGCAGGCTTAAAATA
GTGCAGCCATCTTTATGTTTGATCCCGACA|CCACCATCGCAGCTGCAAATACTTAAAGCG
ATAGTGGGTACCCGTATGTTTGATCCCGAC|TGTTTGATCCTATGTTTGATCCCGACATAG
ACCCGAATGTATGTTTGATCCCGACATAGT|GCAAAAATTATTTGACTCCGAAAACGAGTC
GACATAGTGGGTACCCGAATGTATGTTTGA|GCTTGCTATCGAGCAAAAATTATTTGACTC
CCGCGCGTACGGGGTCGGTATGTATGTTTG|AGTGGGTACCCGAAGTCGTAAATGAGGTGC
GCGGTGCCTCTCTGGTTATCTTCGGACCTG|GAGTCGCCCGCTATGGTTGGAGTTTTGATC
CCCGACATAGTGGGTACCCGCCCGATCTGA|AAATAATTAAAAGCAGCCCGCCGAGTAAAT
GAGGTGCAGCCATCTTTATGTTTGATCCCG|AGACCACCATCGCAGCTGCAAATACTTAAA
TATGTGGCAGGCGGCAATAATCTCATTACG|GGCAGAGGCTTGCACTTGTCACCTAACTAC
CCGTTGATCCCGACATAGTGGGTACCCGTA|GGGGTCGGTATGTATGTTTGATCCTATGTT
GTGCTCTTCATTCGACATGTTCTAGGCATC|GGGTACCCGCCGGGACACACAATCCACACT
GGATCCCGACATAGTGGGTATATGTTTGAT|AAGATAGGCTGAGGGACTTTGATTTCATAA
ACTTTGATTTCATAAAAATAATTAAAAGCA|CCTGCCTTTTAGTGCTCTTCATTCGACATG
ATCCCGACATAGTGGGTACCCGGATCCCGA|CAAAGTGCACATTAGAGGATCAAGATAGGC
ACTAAAGCAAAGGGGCCTGCCTTTTAGTGC|AGAGCTATGTTTGATCCCGACATAGTGGGT
TGATCCCGACATAGTGGGTACCCGGATCCC|GGCAAAGTGCACATTAGAGGATCAAGATAG
CCTTTTAGTGCTCTTCATTCGACATGTTCT|ACATAGTGGGTACCCGCCGGGACACACAAT
CGAGCAAAAATTATTTGACTCCGAAAACGA|TTTGATCCCGACATAGTGGGTACCCGGATC
GTCTTGTAATGGTGAAGCTGACTAAAGCAA|CGAACTCTATCTTATAACGCAGAGCTATGT
GCACATTAGAGGATCAAGATAGGCTGAGGG|GTAATGGTGAAGCTGACTAAAGCAAAGGGG
GTACCCGAAGTCGTAAATGAGGTGCAGCCA|CATGGACTCGATATCCACAGACCACCATCG
ATAGTGGGTACCCGCGACATAGTGGGTACC|CCGACATAGTGGGTACCCGCTTACCGATGG
GTGGGTACTATGTTTGATCCCGACATAGTG|GTACCCGCGACATAGTGGGTACCCGTTTGA
TTGATCCCGACATAGTGGGTACCCGCCGGG|AGTGGGTACCCGTTTGATCCCGACATAGTG
AGTTGGTCCAAAGAATACGTATATTTACAG|GCCGAAAACACGCTCGACCGTTCAATTATC
ACGTATATAGGCAAAGTGCACATTAGAGGA|TTTATTGTCTGTGTCTTGTAATGGTGAAGC
GGTTGGAGTTTTGATCCAATTACCATACGT|CCAGCGGAGTGTATGGACTTGTGCAATTTA
GCCGGGACACACAATCCACACTGGACGCTT|TACGCAATGAAGAATCTTGCAAAGTTCCCA
CAATTATCTTATGTTATGTTTGATCCCGAC|GTAGCACAGACCTTGTAGAAAAATCATGAA
CCGACATAGTGGGTACCCGCTTACCGATGG|AAAGCGGTGCCTCTCTGGTTATCTTCGGAC
ATGGTGAAGCTGACTAAAGCAAAGGGGCCT|ATCTTATAACGCAGAGCTATGTTTGATCCC
AGTCGTAAATGAGGTGCAGCCATCTTTATG|CGATATCCACAGACCACCATCGCAGCTGCA
TGCCTCTCTGGTTATCTTCGGACCTGTATG|CGCCCGCTATGGTTGGAGTTTTGATCCAAT
GTACTATGTTTGATCCCGACATAGTGGGTA|CCGCGACATAGTGGGTACCCGTTTGATCCC
TACCCGACAAGGCGAACTCTATCTTATAAC|TCACCGCTGAAACCGCAGGCTTAAAATAAA
ACATAGTGGGTATATGTTTGATCCCGACAT|CTGAGGGACTTTGATTTCATAAAAATAATT
GTGGGTACCCGTTGATCCCGACATAGTGGG|GCGCGTACGGGGTCGGTATGTATGTTTGAT
CGTATCACCGCTGAAACCGCAGGCTTAAAA|GTAGTTGTTACTGAACACGAACAGAACACT
AGTGGGTATATGTTTGATCCCGACATAGTG|GGGACTTTGATTTCATAAAAATAATTAAAA
CGCAATGAAGAATCTTGCAAAGTTCCCAGA|ACTGAGCGCATACATGCTTTGAGCTTTTTA
AGGGACTTTGATTTCATAAAAATAATTAAA|GGGGCCTGCCTTTTAGTGCTCTTCATTCGA
CAGAGCTATGTTTGATCCCGACATAGTGGG|AGATCGGAATATGTGGCAGGCGGCAATAAT
GATCCCGACATAGTGGGTACCCGCGGCCGA|ACATAGTGGGTACTATGTTTGATCCCGACA
GGAGTTTTGATCCAATTACCATACGTATAT|CGGAGTGTATGGACTTGTGCAATTTATTGT
CTGAATCAATACGGTTGCTGATAGCTGGCC|TGATCCCGACATAGTGGGTACCCGTATGTT
ATGTTTGATCCCGACATAGTGGGTACCCGA|TGCGATCCCGGAGGAGCTGCGTATCACCGC
ATTAAAAGCAGCCCGCCGAGTAAATACTTG|ATTCGACATGTTCTAGGCATCATGGAGAAC
CCACAGACCACCATCGCAGCTGCAAATACT|TTTGATCCCGACATAGTGGGTACCCGCCCG
ACCGCTGAAACCGCAGGCTTAAAATAAAGA|GTTACTGAACACGAACAGAACACTCCTCAA
CCGGAGGAGCTGCGTATCACCGCTGAAACC|GGGTGGGTCAGCGTAGTTGTTACTGAACAC
ATACGTATATTTACAGATAAGCCAACCTGC|CGACCGTTCAATTATCTTATGTTATGTTTG
GCAATAATCTCATTACGCAATGAAGAATCT|ACTTGTCACCTAACTACTGAGCGCATACAT
GCGTATCACCGCTGAAACCGCAGGCTTAAA|CGTAGTTGTTACTGAACACGAACAGAACAC
GCGATCCCGGAGGAGCTGCGTATCACCGCT|CCAAGCGGGTGGGTCAGCGTAGTTGTTACT
CGTATATTTACAGATAAGCCAACCTGCCCA|CCGTTCAATTATCTTATGTTATGTTTGATC
CTGTGTCTTGTAATGGTGAAGCTGACTAAA|AAGGCGAACTCTATCTTATAACGCAGAGCT
TTATGTTATGTTTGATCCCGACATAGTGGG|GACCTTGTAGAAAAATCATGAATCCGCGCG
TCTTATAACGCAGAGCTATGTTTGATCCCG|TAAAATAAAGAGATCGGAATATGTGGCAGG
GCAATGAAGAATCTTGCAAAGTTCCCAGAC|CTGAGCGCATACATGCTTTGAGCTTTTTAC
TACCCGTTTGATCCCGACATAGTGGGTACC|ATGGTGGTATAGGCCGCTTGCTATCGAGCA
CGTTCAATTATCTTATGTTATGTTTGATCC|CCGGGTAGCACAGACCTTGTAGAAAAATCA
CTCCGAAAACGAGTCGACATGGACTCGATA|GGTACCCGGATCCCGACATAGTGGGTATAT
CGCTATGGTTGGAGTTTTGATCCAATTACC|TTAACCCCAGCGGAGTGTATGGACTTGTGC
CCCGAATGTATGTTTGATCCCGACATAGTG|CAAAAATTATTTGACTCCGAAAACGAGTCG
TAATGGTGAAGCTGACTAAAGCAAAGGGGC|CTATCTTATAACGCAGAGCTATGTTTGATC
TTAGTGCTCTTCATTCGACATGTTCTAGGC|AGTGGGTACCCGCCGGGACACACAATCCAC
CGACATAGTGGGTACCCGCGACATAGTGGG|GATCCCGACATAGTGGGTACCCGCTTACCG
GGGTACCCGGATCCCGACATAGTGGGTATA|AGAGGATCAAGATAGGCTGAGGGACTTTGA
AATCATGAATCCGCGCGTACGGGGTCGGTA|ATCCCGACATAGTGGGTACCCGAAGTCGTA
TGTTTGATCCCGACATAGTGGGTACCCGTT|AGAAAAATCATGAATCCGCGCGTACGGGGT
GGAGAACCCTCACAGCTATGTTTGATCCCG|ACGCTTTATCGTCTACGTGCGATCCCGGAG
AAATTATTTGACTCCGAAAACGAGTCGACA|CCGACATAGTGGGTACCCGGATCCCGACAT
GTATATGTTTGATCCCGACATAGTGGGTAC|TTTGATTTCATAAAAATAATTAAAAGCAGC
TACCCGCGGCCGAAAACACGCTCGACCGTT|TTTGATCCCGACATAGTGGGTACCCGCCGG
AATCTTGCAAAGTTCCCAGACGATCAGCCA|TACATGCTTTGAGCTTTTTACTCTGGCAAA
CATGGAGAACCCTCACAGCTATGTTTGATC|TGGACGCTTTATCGTCTACGTGCGATCCCG
TGAATCAATACGGTTGCTGATAGCTGGCCG|GATCCCGACATAGTGGGTACCCGTATGTTT
CTGAGTCGCCCGCTATGGTTGGAGTTTTGA|AAATACTTGCTTAACCCCAGCGGAGTGTAT
AAAGAGATCGGAATATGTGGCAGGCGGCAA|CTCAAGTTAGCATGGCAGAGGCTTGCACTT
GATATCCACAGACCACCATCGCAGCTGCAA|ATATGTTTGATCCCGACATAGTGGGTACCC
TACCCGTTGATCCCGACATAGTGGGTACCC|TACGGGGTCGGTATGTATGTTTGATCCTAT
TGTATGTTTGATCCCGACATAGTGGGTACC|TTATTTGACTCCGAAAACGAGTCGACATGG
CCGCTGAAACCGCAGGCTTAAAATAAAGAG|TTACTGAACACGAACAGAACACTCCTCAAG
GATAGGCTGAGGGACTTTGATTTCATAAAA|TAAAGCAAAGGGGCCTGCCTTTTAGTGCTC
TCAATTATCTTATGTTATGTTTGATCCCGA|GGTAGCACAGACCTTGTAGAAAAATCATGA
CGACATAGTGGGTACCCGCTTACCGATGGT|AAGCGGTGCCTCTCTGGTTATCTTCGGACC
CGACAAGGCGAACTCTATCTTATAACGCAG|CGCTGAAACCGCAGGCTTAAAATAAAGAGA
TCGACCGTTCAATTATCTTATGTTATGTTT|ACCCGCCGGGTAGCACAGACCTTGTAGAAA
AGTGGGTACCCGTTGATCCCGACATAGTGG|CGCGCGTACGGGGTCGGTATGTATGTTTGA
ATGGACTTGTGCAATTTATTGTCTGTGTCT|CCCGACATAGTGGGTACCCGACAAGGCGAA
TAAATACTTGCTTAACCCCAGCGGAGTGTA|CATGGAGAACCCTCACAGCTATGTTTGATC
ATAATTAAAAGCAGCCCGCCGAGTAAATAC|TTCATTCGACATGTTCTAGGCATCATGGAG
CGCGCGTACGGGGTCGGTATGTATGTTTGA|GTGGGTACCCGAAGTCGTAAATGAGGTGCA
ACATAGTGGGTACCCGCGACATAGTGGGTA|TCCCGACATAGTGGGTACCCGCTTACCGAT
TTTACAGATAAGCCAACCTGCCCAACTGGA|AATTATCTTATGTTATGTTTGATCCCGACA
ACACAATCCACACTGGACGCTTTATCGTCT|GAAGAATCTTGCAAAGTTCCCAGACGATCA
CGTTGATCCCGACATAGTGGGTACCCGTAT|GGGTCGGTATGTATGTTTGATCCTATGTTT
TACGGTTGCTGATAGCTGGCCGTATGTTTG|CATAGTGGGTACCCGTATGTTTGATCCCGA
GACATAGTGGGTACCCGTTTGATCCCGACA|CCCGCTTACCGATGGTGGTATAGGCCGCTT
ATAAAGAGATCGGAATATGTGGCAGGCGGC|TCCTCAAGTTAGCATGGCAGAGGCTTGCAC
TATGTTTGATCCCGACATAGTGGGTACCCG|ATCTTTATGTTTGATCCCGACATAGTGGGT
CATAGTGGGTACTATGTTTGATCCCGACAT|GTGGGTACCCGCGACATAGTGGGTACCCGT
ATAGTGGGTACCCGCCGGGACACACAATCC|GCAATAATCTCATTACGCAATGAAGAATCT
CCCGCCCGATCTGAGTCGCCCGCTATGGTT|CCCGCCGAGTAAATACTTGCTTAACCCCAG
CACAGACCTTGTAGAAAAATCATGAATCCG|ACCCGAATGTATGTTTGATCCCGACATAGT
CCCTCACAGCTATGTTTGATCCCGACATAG|TATCGTCTACGTGCGATCCCGGAGGAGCTG
CATAGTGGGTACCCGCCCGATCTGAGTCGC|ATTAAAAGCAGCCCGCCGAGTAAATACTTG
TAAAAGCAGCCCGCCGAGTAAATACTTGCT|TCGACATGTTCTAGGCATCATGGAGAACCC
GCAAAAATTATTTGACTCCGAAAACGAGTC|GATCCCGACATAGTGGGTACCCGGATCCCG
CTCTATCTTATAACGCAGAGCTATGTTTGA|AGGCTTAAAATAAAGAGATCGGAATATGTG
ATGTTTGATCCCGACATAGTGGGTACCCGC|GCAAATACTTAAAGCGGTGCCTCTCTGGTT
CCCGACATAGTGGGTACCCGGATCCCGACA|AAGTGCACATTAGAGGATCAAGATAGGCTG
GGACTTGTGCAATTTATTGTCTGTGTCTTG|CGACATAGTGGGTACCCGACAAGGCGAACT
CAACCTGCCCAACTGGAAAAGCGCAACTGC|TATGTTTGATCCCGACATAGTGGGTACCCG
AGAATACGTATATTTACAGATAAGCCAACC|GCTCGACCGTTCAATTATCTTATGTTATGT
GACATAGTGGGTACCCGGATCCCGACATAG|TGCACATTAGAGGATCAAGATAGGCTGAGG
CATAGTGGGTACCCGCCGGGTAGCACAGAC|CGTTTGATCCCGACATAGTGGGTACCCGAA
AAGCGCAACTGCGCTGAATCAATACGGTTG|AGTGGGTACCCGTTGATCCCGACATAGTGG
AGATAGGCTGAGGGACTTTGATTTCATAAA|CTAAAGCAAAGGGGCCTGCCTTTTAGTGCT
GCTGAGGGACTTTGATTTCATAAAAATAAT|CAAAGGGGCCTGCCTTTTAGTGCTCTTCAT
AAAAATCATGAATCCGCGCGTACGGGGTCG|TTGATCCCGACATAGTGGGTACCCGAAGTC
GTTTGATCCCGACATAGTGGGTACCCGCCC|TTCATAAAAATAATTAAAAGCAGCCCGCCG
CCCGATCTGAGTCGCCCGCTATGGTTGGAG|CCGAGTAAATACTTGCTTAACCCCAGCGGA
CAAAAATTATTTGACTCCGAAAACGAGTCG|ATCCCGACATAGTGGGTACCCGGATCCCGA
ACATAGTGGGTACCCGTTTGATCCCGACAT|CCGCTTACCGATGGTGGTATAGGCCGCTTG
TATGTTATGTTTGATCCCGACATAGTGGGT|ACCTTGTAGAAAAATCATGAATCCGCGCGT
CGACATGTTCTAGGCATCATGGAGAACCCT|GGACACACAATCCACACTGGACGCTTTATC
AAACGAGTCGACATGGACTCGATATCCACA|CGGATCCCGACATAGTGGGTATATGTTTGA
GGTATGTATGTTTGATCCTATGTTTGATCC|CGTAAATGAGGTGCAGCCATCTTTATGTTT
ATCTTATGTTATGTTTGATCCCGACATAGT|ACAGACCTTGTAGAAAAATCATGAATCCGC
AATGGTGAAGCTGACTAAAGCAAAGGGGCC|TATCTTATAACGCAGAGCTATGTTTGATCC
ACATAGTGGGTACCCGCCGGGTAGCACAGA|CCGTTTGATCCCGACATAGTGGGTACCCGA
CTCACAGCTATGTTTGATCCCGACATAGTG|TCGTCTACGTGCGATCCCGGAGGAGCTGCG
CTAGGCATCATGGAGAACCCTCACAGCTAT|ATCCACACTGGACGCTTTATCGTCTACGTG
CGAGTAAATACTTGCTTAACCCCAGCGGAG|GCATCATGGAGAACCCTCACAGCTATGTTT
ATAGTGGGTACCCGTTGATCCCGACATAGT|TCCGCGCGTACGGGGTCGGTATGTATGTTT
TCCGCGCGTACGGGGTCGGTATGTATGTTT|TAGTGGGTACCCGAAGTCGTAAATGAGGTG
CGGCAGTTGGTCCAAAGAATACGTATATTT|CGCGGCCGAAAACACGCTCGACCGTTCAAT
ACATAGTGGGTACCCGCTTACCGATGGTGG|GCGGTGCCTCTCTGGTTATCTTCGGACCTG
ACATAGTGGGTACTATGTTTGATCCCGACA|AGTGGGTACCCGCGACATAGTGGGTACCCG
GGAGTGTATGGACTTGTGCAATTTATTGTC|GTTTGATCCCGACATAGTGGGTACCCGACA
TTTGATCCCGACATAGTGGGTACCCGCCGG|ATGTGGCAGGCGGCAATAATCTCATTACGC
AAGATAGGCTGAGGGACTTTGATTTCATAA|ACTAAAGCAAAGGGGCCTGCCTTTTAGTGC
TTATGTTTGATCCCGACATAGTGGGTACCC|CTGCAAATACTTAAAGCGGTGCCTCTCTGG
TATGTTTGATCCCGACATAGTGGGTACTAT|TTTGATCCCGACATAGTGGGTACCCGCGAC
ATACTTAAAGCGGTGCCTCTCTGGTTATCT|GCCCGATCTGAGTCGCCCGCTATGGTTGGA
ATTATCTTATGTTATGTTTGATCCCGACAT|AGCACAGACCTTGTAGAAAAATCATGAATC
TCCCGACATAGTGGGTACTATGTTTGATCC|GACATAGTGGGTACCCGCGACATAGTGGGT
CAGGCTTAAAATAAAGAGATCGGAATATGT|AACAGAACACTCCTCAAGTTAGCATGGCAG
GATCCCGACATAGTGGGTACCCGCCGGGAC|TGGCAGGCGGCAATAATCTCATTACGCAAT
GATCGGAATATGTGGCAGGCGGCAATAATC|GTTAGCATGGCAGAGGCTTGCACTTGTCAC
CGACATAGTGGGTACCCGTTTGATCCCGAC|ACCCGCTTACCGATGGTGGTATAGGCCGCT
ACCCGTTTGATCCCGACATAGTGGGTACCC|TGGTGGTATAGGCCGCTTGCTATCGAGCAA
GCTCTTCATTCGACATGTTCTAGGCATCAT|GTACCCGCCGGGACACACAATCCACACTGG
GAGTGTATGGACTTGTGCAATTTATTGTCT|TTTGATCCCGACATAGTGGGTACCCGACAA
GAATATGTGGCAGGCGGCAATAATCTCATT|CATGGCAGAGGCTTGCACTTGTCACCTAAC
CGACATAGTGGGTACCCGAATGTATGTTTG|CGCTTGCTATCGAGCAAAAATTATTTGACT
TAGCACAGACCTTGTAGAAAAATCATGAAT|GGTACCCGAATGTATGTTTGATCCCGACAT
TATGTTTGATCCTATGTTTGATCCCGACAT|TGAGGTGCAGCCATCTTTATGTTTGATCCC
ATGGACTCGATATCCACAGACCACCATCGC|TAGTGGGTATATGTTTGATCCCGACATAGT
CCGCGACATAGTGGGTACCCGTTTGATCCC|GGTACCCGCTTACCGATGGTGGTATAGGCC
AGGCGGCAATAATCTCATTACGCAATGAAG|CTTGCACTTGTCACCTAACTACTGAGCGCA
CGTTTGATCCCGACATAGTGGGTACCCGAA|TGGTATAGGCCGCTTGCTATCGAGCAAAAA
TGTGTCTTGTAATGGTGAAGCTGACTAAAG|AGGCGAACTCTATCTTATAACGCAGAGCTA
TATGTTTGATCCCGACATAGTGGGTACCCG|GATTTCATAAAAATAATTAAAAGCAGCCCG
ATCATGAATCCGCGCGTACGGGGTCGGTAT|TCCCGACATAGTGGGTACCCGAAGTCGTAA
GTACCCGCCGGGACACACAATCCACACTGG|TCTCATTACGCAATGAAGAATCTTGCAAAG
GACATAGTGGGTACCCGAAGTCGTAAATGA|AACGAGTCGACATGGACTCGATATCCACAG
ATAATCTCATTACGCAATGAAGAATCTTGC|TGTCACCTAACTACTGAGCGCATACATGCT
ATCCCGACATAGTGGGTACCCGCCGGGTAG|GGGTACCCGTTTGATCCCGACATAGTGGGT
TGGCCGTATGTTTGATCCCGACATAGTGGG|ATGTTTGATCCCGACATAGTGGGTACTATG
TTGATCCCGACATAGTGGGTACCCGCGACA|TATGTTTGATCCCGACATAGTGGGTACCCG
AACCCTCACAGCTATGTTTGATCCCGACAT|TTTATCGTCTACGTGCGATCCCGGAGGAGC
CGGACCTGTATGAATATGTTTTATGTTTGA|TTTTGATCCAATTACCATACGTATATAGGC
GAAAAGCGCAACTGCGCTGAATCAATACGG|CATAGTGGGTACCCGTTGATCCCGACATAG
CGATATCCACAGACCACCATCGCAGCTGCA|TATATGTTTGATCCCGACATAGTGGGTACC
GTGCAATTTATTGTCTGTGTCTTGTAATGG|AGTGGGTACCCGACAAGGCGAACTCTATCT
CGACATAGTGGGTACCCGTTGATCCCGACA|TGAATCCGCGCGTACGGGGTCGGTATGTAT
GCTTTATCGTCTACGTGCGATCCCGGAGGA|CCCAGACGATCAGCCACCAAGCGGGTGGGT
TGGTTATCTTCGGACCTGTATGAATATGTT|ATGGTTGGAGTTTTGATCCAATTACCATAC
TCTATCTTATAACGCAGAGCTATGTTTGAT|GGCTTAAAATAAAGAGATCGGAATATGTGG
ATGAGGTGCAGCCATCTTTATGTTTGATCC|ACAGACCACCATCGCAGCTGCAAATACTTA
TTTGATCCCGACATAGTGGGTACCCGACAA|GATCCCGGAGGAGCTGCGTATCACCGCTGA
GTGCGATCCCGGAGGAGCTGCGTATCACCG|CACCAAGCGGGTGGGTCAGCGTAGTTGTTA
TTCCCAGACGATCAGCCACCAAGCGGGTGG|GCTTTTTACTCTGGCAAATTGTTTCAAAAT
CGACATAGTGGGTACCCGTATGTTTGATCC|TGTATGTTTGATCCTATGTTTGATCCCGAC
CCGACATAGTGGGTATATGTTTGATCCCGA|AGGCTGAGGGACTTTGATTTCATAAAAATA
ATAGTGGGTACCCGAAGTCGTAAATGAGGT|GAGTCGACATGGACTCGATATCCACAGACC
TTCTAGGCATCATGGAGAACCCTCACAGCT|CAATCCACACTGGACGCTTTATCGTCTACG
ATGTTTGATCCCGACATAGTGGGTACCCGG|ATATAGGCAAAGTGCACATTAGAGGATCAA
TATGTTTGATCCCGACATAGTGGGTACCCG|GTGCGATCCCGGAGGAGCTGCGTATCACCG
AGTCGCCCGCTATGGTTGGAGTTTTGATCC|TACTTGCTTAACCCCAGCGGAGTGTATGGA
CACAGACCACCATCGCAGCTGCAAATACTT|TTGATCCCGACATAGTGGGTACCCGCCCGA
GCAAAGTTCCCAGACGATCAGCCACCAAGC|CTTTGAGCTTTTTACTCTGGCAAATTGTTT
TCTGAGTCGCCCGCTATGGTTGGAGTTTTG|TAAATACTTGCTTAACCCCAGCGGAGTGTA
GTGGGTACCCGACAAGGCGAACTCTATCTT|GCGTATCACCGCTGAAACCGCAGGCTTAAA
ATCACCGCTGAAACCGCAGGCTTAAAATAA|GTTGTTACTGAACACGAACAGAACACTCCT
ATCCGCGCGTACGGGGTCGGTATGTATGTT|ATAGTGGGTACCCGAAGTCGTAAATGAGGT
GCGCGTACGGGGTCGGTATGTATGTTTGAT|TGGGTACCCGAAGTCGTAAATGAGGTGCAG
GCCTTTTAGTGCTCTTCATTCGACATGTTC|GACATAGTGGGTACCCGCCGGGACACACAA
GGCCTGCCTTTTAGTGCTCTTCATTCGACA|ATCCCGACATAGTGGGTACCCGCCGGGACA
TGGACGCTTTATCGTCTACGTGCGATCCCG|AAGTTCCCAGACGATCAGCCACCAAGCGGG
TGTGCAATTTATTGTCTGTGTCTTGTAATG|TAGTGGGTACCCGACAAGGCGAACTCTATC
TATGTTTGATCCCGACATAGTGGGTACCCG|TATATAGGCAAAGTGCACATTAGAGGATCA
CGCAGCTGCAAATACTTAAAGCGGTGCCTC|AGTGGGTACCCGCCCGATCTGAGTCGCCCG
CGACATAGTGGGTACCCGCCGGGTAGCACA|ACCCGTTTGATCCCGACATAGTGGGTACCC
CCGACATAGTGGGTACCCGTATGTTTGATC|ATGTATGTTTGATCCTATGTTTGATCCCGA
ACCCGCGACATAGTGGGTACCCGTTTGATC|TGGGTACCCGCTTACCGATGGTGGTATAGG
ACACACAATCCACACTGGACGCTTTATCGT|ATGAAGAATCTTGCAAAGTTCCCAGACGAT
TCCCGACATAGTGGGTACCCGACAAGGCGA|CGGAGGAGCTGCGTATCACCGCTGAAACCG
CAGCTATGTTTGATCCCGACATAGTGGGTA|CTACGTGCGATCCCGGAGGAGCTGCGTATC
TGCAATTTATTGTCTGTGTCTTGTAATGGT|GTGGGTACCCGACAAGGCGAACTCTATCTT
CAACTGGAAAAGCGCAACTGCGCTGAATCA|TCCCGACATAGTGGGTACCCGTTGATCCCG
GGCTGAGGGACTTTGATTTCATAAAAATAA|GCAAAGGGGCCTGCCTTTTAGTGCTCTTCA
ATAGGCCGCTTGCTATCGAGCAAAAATTAT|ATGAATATGTTTTATGTTTGATCCCGACAT
CACAATCCACACTGGACGCTTTATCGTCTA|AAGAATCTTGCAAAGTTCCCAGACGATCAG
TGGGTACCCGTTGATCCCGACATAGTGGGT|CGCGTACGGGGTCGGTATGTATGTTTGATC
TGGCAGGCGGCAATAATCTCATTACGCAAT|GAGGCTTGCACTTGTCACCTAACTACTGAG
CTGGTTATCTTCGGACCTGTATGAATATGT|TATGGTTGGAGTTTTGATCCAATTACCATA
CTGAGGGACTTTGATTTCATAAAAATAATT|AAAGGGGCCTGCCTTTTAGTGCTCTTCATT
TAGTGGGTACCCGTTGATCCCGACATAGTG|CCGCGCGTACGGGGTCGGTATGTATGTTTG
GGTTATCTTCGGACCTGTATGAATATGTTT|TGGTTGGAGTTTTGATCCAATTACCATACG
CTTGTAATGGTGAAGCTGACTAAAGCAAAG|AACTCTATCTTATAACGCAGAGCTATGTTT
CAAATACTTAAAGCGGTGCCTCTCTGGTTA|CCCGCCCGATCTGAGTCGCCCGCTATGGTT
TGTTTGATCCCGACATAGTGGGTACCCGAA|TTGACTCCGAAAACGAGTCGACATGGACTC
GGACTCGATATCCACAGACCACCATCGCAG|GTGGGTATATGTTTGATCCCGACATAGTGG
CAAGGCGAACTCTATCTTATAACGCAGAGC|TGAAACCGCAGGCTTAAAATAAAGAGATCG
AGGCATCATGGAGAACCCTCACAGCTATGT|CCACACTGGACGCTTTATCGTCTACGTGCG
GACATAGTGGGTACTATGTTTGATCCCGAC|TAGTGGGTACCCGCGACATAGTGGGTACCC
TGTCTTGTAATGGTGAAGCTGACTAAAGCA|GCGAACTCTATCTTATAACGCAGAGCTATG
GCGGAGTGTATGGACTTGTGCAATTTATTG|ATGTTTGATCCCGACATAGTGGGTACCCGA
GCTATCGAGCAAAAATTATTTGACTCCGAA|TTATGTTTGATCCCGACATAGTGGGTACCC
CATCATGGAGAACCCTCACAGCTATGTTTG|CACTGGACGCTTTATCGTCTACGTGCGATC
TCCCGACATAGTGGGTATATGTTTGATCCC|ATAGGCTGAGGGACTTTGATTTCATAAAAA
CTATGTTTGATCCCGACATAGTGGGTACCC|GGAATATGTGGCAGGCGGCAATAATCTCAT
TCTGTGTCTTGTAATGGTGAAGCTGACTAA|CAAGGCGAACTCTATCTTATAACGCAGAGC
AAAGAATACGTATATTTACAGATAAGCCAA|ACGCTCGACCGTTCAATTATCTTATGTTAT
CAGCCCGCCGAGTAAATACTTGCTTAACCC|TGTTCTAGGCATCATGGAGAACCCTCACAG
GACATGGACTCGATATCCACAGACCACCAT|ACATAGTGGGTATATGTTTGATCCCGACAT
GTGCCTCTCTGGTTATCTTCGGACCTGTAT|TCGCCCGCTATGGTTGGAGTTTTGATCCAA
ATGTTCTAGGCATCATGGAGAACCCTCACA|ACACAATCCACACTGGACGCTTTATCGTCT
CCGATCTGAGTCGCCCGCTATGGTTGGAGT|CGAGTAAATACTTGCTTAACCCCAGCGGAG
ATGTTTGATCCCGACATAGTGGGTACCCGC|ACATAGTGGGTACCCGTTTGATCCCGACAT
GAATCCGCGCGTACGGGGTCGGTATGTATG|ACATAGTGGGTACCCGAAGTCGTAAATGAG
AACCCCAGCGGAGTGTATGGACTTGTGCAA|CACAGCTATGTTTGATCCCGACATAGTGGG
TACCCGCCCGATCTGAGTCGCCCGCTATGG|AGCCCGCCGAGTAAATACTTGCTTAACCCC
TCGAGCAAAAATTATTTGACTCCGAAAACG|GTTTGATCCCGACATAGTGGGTACCCGGAT
TACTTAAAGCGGTGCCTCTCTGGTTATCTT|CCCGATCTGAGTCGCCCGCTATGGTTGGAG
AGTGGGTACCCGAATGTATGTTTGATCCCG|CTATCGAGCAAAAATTATTTGACTCCGAAA
CCGTATGTTTGATCCCGACATAGTGGGTAC|ATGTTTGATCCCGACATAGTGGGTACCCGC
AAAAATAATTAAAAGCAGCCCGCCGAGTAA|GCTCTTCATTCGACATGTTCTAGGCATCAT
TGGGTACCCGCCCGATCTGAGTCGCCCGCT|AAGCAGCCCGCCGAGTAAATACTTGCTTAA
TGATCCCGACATAGTGGGTACCCGAATGTA|ATAGGCCGCTTGCTATCGAGCAAAAATTAT
CCCGCCGGGACACACAATCCACACTGGACG|CATTACGCAATGAAGAATCTTGCAAAGTTC
TCTCATTACGCAATGAAGAATCTTGCAAAG|ACCTAACTACTGAGCGCATACATGCTTTGA
TATATAGGCAAAGTGCACATTAGAGGATCA|ATTGTCTGTGTCTTGTAATGGTGAAGCTGA
GCCCAACTGGAAAAGCGCAACTGCGCTGAA|TGATCCCGACATAGTGGGTACCCGTTGATC
TTTATGTTTGATCCCGACATAGTGGGTACC|GCTGCAAATACTTAAAGCGGTGCCTCTCTG
CCGCTATGGTTGGAGTTTTGATCCAATTAC|CTTAACCCCAGCGGAGTGTATGGACTTGTG
CAGCCATCTTTATGTTTGATCCCGACATAG|CCATCGCAGCTGCAAATACTTAAAGCGGTG
CACACTGGACGCTTTATCGTCTACGTGCGA|TTGCAAAGTTCCCAGACGATCAGCCACCAA
CGAAAACACGCTCGACCGTTCAATTATCTT|ACATAGTGGGTACCCGCCGGGTAGCACAGA
GTTTGATCCCGACATAGTGGGTACCCGCGA|TTTATGTTTGATCCCGACATAGTGGGTACC
GGTAGCACAGACCTTGTAGAAAAATCATGA|TGGGTACCCGAATGTATGTTTGATCCCGAC
ACAGCTATGTTTGATCCCGACATAGTGGGT|TCTACGTGCGATCCCGGAGGAGCTGCGTAT
GGGTACCCGCGACATAGTGGGTACCCGTTT|ATAGTGGGTACCCGCTTACCGATGGTGGTA
ATCCCGACATAGTGGGTACCCGAATGTATG|AGGCCGCTTGCTATCGAGCAAAAATTATTT
GGTGCAGCCATCTTTATGTTTGATCCCGAC|ACCACCATCGCAGCTGCAAATACTTAAAGC
CCCGACATAGTGGGTACCCGTTGATCCCGA|CATGAATCCGCGCGTACGGGGTCGGTATGT
CGTGCGATCCCGGAGGAGCTGCGTATCACC|CCACCAAGCGGGTGGGTCAGCGTAGTTGTT
CCCGTTTGATCCCGACATAGTGGGTACCCG|GGTGGTATAGGCCGCTTGCTATCGAGCAAA
CCGCCGAGTAAATACTTGCTTAACCCCAGC|CTAGGCATCATGGAGAACCCTCACAGCTAT
TATGTATGTTTGATCCTATGTTTGATCCCG|TAAATGAGGTGCAGCCATCTTTATGTTTGA
CCACACTGGACGCTTTATCGTCTACGTGCG|CTTGCAAAGTTCCCAGACGATCAGCCACCA
TGCAAATACTTAAAGCGGTGCCTCTCTGGT|TACCCGCCCGATCTGAGTCGCCCGCTATGG
CCGCTTGCTATCGAGCAAAAATTATTTGAC|TATGTTTTATGTTTGATCCCGACATAGTGG
TAAAGCGGTGCCTCTCTGGTTATCTTCGGA|ATCTGAGTCGCCCGCTATGGTTGGAGTTTT
TACCCGCCGGGTAGCACAGACCTTGTAGAA|CCGACATAGTGGGTACCCGAATGTATGTTT
AGTGGGTACCCGCGACATAGTGGGTACCCG|GACATAGTGGGTACCCGCTTACCGATGGTG
CACAGCTATGTTTGATCCCGACATAGTGGG|GTCTACGTGCGATCCCGGAGGAGCTGCGTA
TATAGGCCGCTTGCTATCGAGCAAAAATTA|TATGAATATGTTTTATGTTTGATCCCGACA
TTGCAAAGTTCCCAGACGATCAGCCACCAA|TGCTTTGAGCTTTTTACTCTGGCAAATTGT
TGTTCTAGGCATCATGGAGAACCCTCACAG|CACAATCCACACTGGACGCTTTATCGTCTA
TCGGAATATGTGGCAGGCGGCAATAATCTC|TAGCATGGCAGAGGCTTGCACTTGTCACCT
TTGATCCCGACATAGTGGGTACCCGAATGT|TATAGGCCGCTTGCTATCGAGCAAAAATTA
CACGCTCGACCGTTCAATTATCTTATGTTA|TGGGTACCCGCCGGGTAGCACAGACCTTGT
ACAGACCTTGTAGAAAAATCATGAATCCGC|CCCGAATGTATGTTTGATCCCGACATAGTG
ATGGTTGGAGTTTTGATCCAATTACCATAC|CCCCAGCGGAGTGTATGGACTTGTGCAATT
CCGACATAGTGGGTACCCGGATCCCGACAT|AGTGCACATTAGAGGATCAAGATAGGCTGA
ACATAGTGGGTACCCGCGGCCGAAAACACG|GGGTACTATGTTTGATCCCGACATAGTGGG
TGATAGCTGGCCGTATGTTTGATCCCGACA|TACCCGTATGTTTGATCCCGACATAGTGGG
AAAAGCGCAACTGCGCTGAATCAATACGGT|ATAGTGGGTACCCGTTGATCCCGACATAGT
GACATAGTGGGTACCCGCCGGGTAGCACAG|CCCGTTTGATCCCGACATAGTGGGTACCCG
GGGTACCCGTTGATCCCGACATAGTGGGTA|GCGTACGGGGTCGGTATGTATGTTTGATCC
GGTACCCGGATCCCGACATAGTGGGTATAT|GAGGATCAAGATAGGCTGAGGGACTTTGAT
CGTATGTTTGATCCCGACATAGTGGGTACT|TGTTTGATCCCGACATAGTGGGTACCCGCG
AAACCGCAGGCTTAAAATAAAGAGATCGGA|AACACGAACAGAACACTCCTCAAGTTAGCA
GCATCATGGAGAACCCTCACAGCTATGTTT|ACACTGGACGCTTTATCGTCTACGTGCGAT
AAAGCAGCCCGCCGAGTAAATACTTGCTTA|GACATGTTCTAGGCATCATGGAGAACCCTC
GTGGGTACCCGCCGGGACACACAATCCACA|ATAATCTCATTACGCAATGAAGAATCTTGC
TGTTTGATCCCGACATAGTGGGTACCCGCC|CATAGTGGGTACCCGTTTGATCCCGACATA
ATCCAATTACCATACGTATATAGGCAAAGT|TGGACTTGTGCAATTTATTGTCTGTGTCTT
GAGAACCCTCACAGCTATGTTTGATCCCGA|CGCTTTATCGTCTACGTGCGATCCCGGAGG
CCCGCTATGGTTGGAGTTTTGATCCAATTA|GCTTAACCCCAGCGGAGTGTATGGACTTGT
TGGACTCGATATCCACAGACCACCATCGCA|AGTGGGTATATGTTTGATCCCGACATAGTG
GCTGAATCAATACGGTTGCTGATAGCTGGC|TTGATCCCGACATAGTGGGTACCCGTATGT
ATCCCGACATAGTGGGTACCCGACAAGGCG|CCGGAGGAGCTGCGTATCACCGCTGAAACC
GGTACCCGAAGTCGTAAATGAGGTGCAGCC|ACATGGACTCGATATCCACAGACCACCATC
TCGGCAGTTGGTCCAAAGAATACGTATATT|CCGCGGCCGAAAACACGCTCGACCGTTCAA
GGTGGTATAGGCCGCTTGCTATCGAGCAAA|ACCTGTATGAATATGTTTTATGTTTGATCC
GATCCCGACATAGTGGGTACCCGTTGATCC|AATCATGAATCCGCGCGTACGGGGTCGGTA
TCAAGATAGGCTGAGGGACTTTGATTTCAT|TGACTAAAGCAAAGGGGCCTGCCTTTTAGT
GACACACAATCCACACTGGACGCTTTATCG|AATGAAGAATCTTGCAAAGTTCCCAGACGA
CTATGGTTGGAGTTTTGATCCAATTACCAT|AACCCCAGCGGAGTGTATGGACTTGTGCAA
GGTACCCGCCGGGACACACAATCCACACTG|ATCTCATTACGCAATGAAGAATCTTGCAAA
AATAAAGAGATCGGAATATGTGGCAGGCGG|CTCCTCAAGTTAGCATGGCAGAGGCTTGCA
GTTTGATCCCGACATAGTGGGTACCCGCTT|AAATACTTAAAGCGGTGCCTCTCTGGTTAT
TCTACGTGCGATCCCGGAGGAGCTGCGTAT|TCAGCCACCAAGCGGGTGGGTCAGCGTAGT
ACATAGTGGGTACCCGCCGGGACACACAAT|CGGCAATAATCTCATTACGCAATGAAGAAT
TTACCATACGTATATAGGCAAAGTGCACAT|TGTGCAATTTATTGTCTGTGTCTTGTAATG
TTTGATCCCGACATAGTGGGTACCCGTTGA|AAAAATCATGAATCCGCGCGTACGGGGTCG
GATCAAGATAGGCTGAGGGACTTTGATTTC|GCTGACTAAAGCAAAGGGGCCTGCCTTTTA
TACGCAATGAAGAATCTTGCAAAGTTCCCA|CTACTGAGCGCATACATGCTTTGAGCTTTT
TCGACATGGACTCGATATCCACAGACCACC|CGACATAGTGGGTATATGTTTGATCCCGAC
GCTTGCTATCGAGCAAAAATTATTTGACTC|TGTTTTATGTTTGATCCCGACATAGTGGGT
TGGTTGGAGTTTTGATCCAATTACCATACG|CCCAGCGGAGTGTATGGACTTGTGCAATTT
ACGCTCGACCGTTCAATTATCTTATGTTAT|GGGTACCCGCCGGGTAGCACAGACCTTGTA
GTGGGTACCCGGATCCCGACATAGTGGGTA|TTAGAGGATCAAGATAGGCTGAGGGACTTT
CAGATAAGCCAACCTGCCCAACTGGAAAAG|ATCTTATGTTATGTTTGATCCCGACATAGT
CGAAGTCGTAAATGAGGTGCAGCCATCTTT|ACTCGATATCCACAGACCACCATCGCAGCT
ATCAAGATAGGCTGAGGGACTTTGATTTCA|CTGACTAAAGCAAAGGGGCCTGCCTTTTAG
CCGACATAGTGGGTACCCGTTGATCCCGAC|ATGAATCCGCGCGTACGGGGTCGGTATGTA
CTTATAACGCAGAGCTATGTTTGATCCCGA|AAAATAAAGAGATCGGAATATGTGGCAGGC
AAAGCGGTGCCTCTCTGGTTATCTTCGGAC|TCTGAGTCGCCCGCTATGGTTGGAGTTTTG
CGTAAATGAGGTGCAGCCATCTTTATGTTT|TATCCACAGACCACCATCGCAGCTGCAAAT
CCCGACATAGTGGGTACCCGCCGGGTAGCA|GTACCCGTTTGATCCCGACATAGTGGGTAC
GAATCAATACGGTTGCTGATAGCTGGCCGT|ATCCCGACATAGTGGGTACCCGTATGTTTG
TATCTTATGTTATGTTTGATCCCGACATAG|CACAGACCTTGTAGAAAAATCATGAATCCG
CGACATAGTGGGTATATGTTTGATCCCGAC|GGCTGAGGGACTTTGATTTCATAAAAATAA
AAGGCGAACTCTATCTTATAACGCAGAGCT|GAAACCGCAGGCTTAAAATAAAGAGATCGG
TCCCGACATAGTGGGTACCCGCTTACCGAT|TTAAAGCGGTGCCTCTCTGGTTATCTTCGG
ATCTCATTACGCAATGAAGAATCTTGCAAA|CACCTAACTACTGAGCGCATACATGCTTTG
TCCCGACATAGTGGGTACCCGCCGGGACAC|GCAGGCGGCAATAATCTCATTACGCAATGA
GGCAATAATCTCATTACGCAATGAAGAATC|CACTTGTCACCTAACTACTGAGCGCATACA
AGAACCCTCACAGCTATGTTTGATCCCGAC|GCTTTATCGTCTACGTGCGATCCCGGAGGA
TGCAAAGTTCCCAGACGATCAGCCACCAAG|GCTTTGAGCTTTTTACTCTGGCAAATTGTT
TCCCGACATAGTGGGTACCCGAAGTCGTAA|CGAAAACGAGTCGACATGGACTCGATATCC
TGTTATGTTTGATCCCGACATAGTGGGTAC|CTTGTAGAAAAATCATGAATCCGCGCGTAC
TTCGACATGTTCTAGGCATCATGGAGAACC|CGGGACACACAATCCACACTGGACGCTTTA
GGGGTCGGTATGTATGTTTGATCCTATGTT|CGAAGTCGTAAATGAGGTGCAGCCATCTTT
TGATCCCGACATAGTGGGTACCCGCCGGGT|GTGGGTACCCGTTTGATCCCGACATAGTGG
AAGCAAAGGGGCCTGCCTTTTAGTGCTCTT|CTATGTTTGATCCCGACATAGTGGGTACCC
AAGCAGCCCGCCGAGTAAATACTTGCTTAA|ACATGTTCTAGGCATCATGGAGAACCCTCA
AACGCAGAGCTATGTTTGATCCCGACATAG|AAAGAGATCGGAATATGTGGCAGGCGGCAA
AGTGGGTACCCGCGGCCGAAAACACGCTCG|ACTATGTTTGATCCCGACATAGTGGGTACC
TTATGTTTGATCCCGACATAGTGGGTACCC|TGTAGAAAAATCATGAATCCGCGCGTACGG
GGCCGTATGTTTGATCCCGACATAGTGGGT|TGTTTGATCCCGACATAGTGGGTACTATGT
TTTGATCCCGACATAGTGGGTACCCGCGAC|TTATGTTTGATCCCGACATAGTGGGTACCC
AGAGATCGGAATATGTGGCAGGCGGCAATA|CAAGTTAGCATGGCAGAGGCTTGCACTTGT
AGCTGGCCGTATGTTTGATCCCGACATAGT|CGTATGTTTGATCCCGACATAGTGGGTACT
ATCCCGACATAGTGGGTACCCGCCCGATCT|AAAAATAATTAAAAGCAGCCCGCCGAGTAA
AACCGCAGGCTTAAAATAAAGAGATCGGAA|ACACGAACAGAACACTCCTCAAGTTAGCAT
TTGCTGATAGCTGGCCGTATGTTTGATCCC|TGGGTACCCGTATGTTTGATCCCGACATAG
TGAATATGTTTTATGTTTGATCCCGACATA|ATTACCATACGTATATAGGCAAAGTGCACA
CTATGTTTGATCCCGACATAGTGGGTACCC|CGACATAGTGGGTACCCGTTTGATCCCGAC
GATCCCGACATAGTGGGTACCCGGATCCCG|GCAAAGTGCACATTAGAGGATCAAGATAGG
CCCGGAGGAGCTGCGTATCACCGCTGAAAC|CGGGTGGGTCAGCGTAGTTGTTACTGAACA
ATCTTTATGTTTGATCCCGACATAGTGGGT|GCAGCTGCAAATACTTAAAGCGGTGCCTCT
CTTAACCCCAGCGGAGTGTATGGACTTGTG|CCTCACAGCTATGTTTGATCCCGACATAGT
ATACGTATATAGGCAAAGTGCACATTAGAG|AATTTATTGTCTGTGTCTTGTAATGGTGAA
AGTTCCCAGACGATCAGCCACCAAGCGGGT|GAGCTTTTTACTCTGGCAAATTGTTTCAAA
AGGCTTAAAATAAAGAGATCGGAATATGTG|ACAGAACACTCCTCAAGTTAGCATGGCAGA
TAAATGAGGTGCAGCCATCTTTATGTTTGA|TCCACAGACCACCATCGCAGCTGCAAATAC
GTCTACGTGCGATCCCGGAGGAGCTGCGTA|ATCAGCCACCAAGCGGGTGGGTCAGCGTAG
GTCGTAAATGAGGTGCAGCCATCTTTATGT|GATATCCACAGACCACCATCGCAGCTGCAA
GCAGCCATCTTTATGTTTGATCCCGACATA|ACCATCGCAGCTGCAAATACTTAAAGCGGT
CTTTGATTTCATAAAAATAATTAAAAGCAG|CTGCCTTTTAGTGCTCTTCATTCGACATGT
ACACTGGACGCTTTATCGTCTACGTGCGAT|TGCAAAGTTCCCAGACGATCAGCCACCAAG
ATTACGCAATGAAGAATCTTGCAAAGTTCC|AACTACTGAGCGCATACATGCTTTGAGCTT
GAGCAAAAATTATTTGACTCCGAAAACGAG|TTGATCCCGACATAGTGGGTACCCGGATCC
GTCTGTGTCTTGTAATGGTGAAGCTGACTA|ACAAGGCGAACTCTATCTTATAACGCAGAG
ATGAATCCGCGCGTACGGGGTCGGTATGTA|CGACATAGTGGGTACCCGAAGTCGTAAATG
CACCATCGCAGCTGCAAATACTTAAAGCGG|CGACATAGTGGGTACCCGCCCGATCTGAGT
CCCGACATAGTGGGTACTATGTTTGATCCC|ACATAGTGGGTACCCGCGACATAGTGGGTA
TACCCGCTTACCGATGGTGGTATAGGCCGC|TCTGGTTATCTTCGGACCTGTATGAATATG
AAAATAATTAAAAGCAGCCCGCCGAGTAAA|CTCTTCATTCGACATGTTCTAGGCATCATG
TGGGTACCCGCCGGGTAGCACAGACCTTGT|GATCCCGACATAGTGGGTACCCGAATGTAT
TAGAAAAATCATGAATCCGCGCGTACGGGG|TGTTTGATCCCGACATAGTGGGTACCCGAA
GATCCCGACATAGTGGGTACCCGACAAGGC|CCCGGAGGAGCTGCGTATCACCGCTGAAAC
ATAAAAATAATTAAAAGCAGCCCGCCGAGT|GTGCTCTTCATTCGACATGTTCTAGGCATC
ACCGTTCAATTATCTTATGTTATGTTTGAT|CGCCGGGTAGCACAGACCTTGTAGAAAAAT
CCCAGCGGAGTGTATGGACTTGTGCAATTT|AGCTATGTTTGATCCCGACATAGTGGGTAC
AATTTATTGTCTGTGTCTTGTAATGGTGAA|GGTACCCGACAAGGCGAACTCTATCTTATA
AGTGCTCTTCATTCGACATGTTCTAGGCAT|TGGGTACCCGCCGGGACACACAATCCACAC
CCCGACATAGTGGGTACCCGCTTACCGATG|TAAAGCGGTGCCTCTCTGGTTATCTTCGGA
TGAAGCTGACTAAAGCAAAGGGGCCTGCCT|TATAACGCAGAGCTATGTTTGATCCCGACA
GTATGTTTGATCCCGACATAGTGGGTACTA|GTTTGATCCCGACATAGTGGGTACCCGCGA
CTTTATCGTCTACGTGCGATCCCGGAGGAG|CCAGACGATCAGCCACCAAGCGGGTGGGTC
TAATTAAAAGCAGCCCGCCGAGTAAATACT|TCATTCGACATGTTCTAGGCATCATGGAGA
CATAGTGGGTACCCGCTTACCGATGGTGGT|CGGTGCCTCTCTGGTTATCTTCGGACCTGT
GAGTCGACATGGACTCGATATCCACAGACC|TCCCGACATAGTGGGTATATGTTTGATCCC
TCATTACGCAATGAAGAATCTTGCAAAGTT|CTAACTACTGAGCGCATACATGCTTTGAGC
AAAAATTATTTGACTCCGAAAACGAGTCGA|TCCCGACATAGTGGGTACCCGGATCCCGAC
CTTGCTTAACCCCAGCGGAGTGTATGGACT|GAACCCTCACAGCTATGTTTGATCCCGACA
AGTTTTGATCCAATTACCATACGTATATAG|GAGTGTATGGACTTGTGCAATTTATTGTCT
AAAACGAGTCGACATGGACTCGATATCCAC|CCGGATCCCGACATAGTGGGTATATGTTTG
GCTGCAAATACTTAAAGCGGTGCCTCTCTG|GGTACCCGCCCGATCTGAGTCGCCCGCTAT
CCACCATCGCAGCTGCAAATACTTAAAGCG|CCGACATAGTGGGTACCCGCCCGATCTGAG
GACATAGTGGGTACCCGCGACATAGTGGGT|ATCCCGACATAGTGGGTACCCGCTTACCGA
TCCCGACATAGTGGGTACCCGGATCCCGAC|AAAGTGCACATTAGAGGATCAAGATAGGCT
TGGGTACCCGTATGTTTGATCCCGACATAG|TGATCCTATGTTTGATCCCGACATAGTGGG
ACCCGCTTACCGATGGTGGTATAGGCCGCT|CTGGTTATCTTCGGACCTGTATGAATATGT
GATAAGCCAACCTGCCCAACTGGAAAAGCG|CTTATGTTATGTTTGATCCCGACATAGTGG
AATAATCTCATTACGCAATGAAGAATCTTG|TTGTCACCTAACTACTGAGCGCATACATGC
TCCCAGACGATCAGCCACCAAGCGGGTGGG|CTTTTTACTCTGGCAAATTGTTTCAAAATT
GACTAAAGCAAAGGGGCCTGCCTTTTAGTG|CAGAGCTATGTTTGATCCCGACATAGTGGG
ATACGGTTGCTGATAGCTGGCCGTATGTTT|ACATAGTGGGTACCCGTATGTTTGATCCCG
TAGTGGGTACCCGCCGGGACACACAATCCA|CAATAATCTCATTACGCAATGAAGAATCTT
GATCCCGACATAGTGGGTACCCGCCCGATC|TAAAAATAATTAAAAGCAGCCCGCCGAGTA
GACAAGGCGAACTCTATCTTATAACGCAGA|GCTGAAACCGCAGGCTTAAAATAAAGAGAT
GATAGCTGGCCGTATGTTTGATCCCGACAT|ACCCGTATGTTTGATCCCGACATAGTGGGT
ACGGTTGCTGATAGCTGGCCGTATGTTTGA|ATAGTGGGTACCCGTATGTTTGATCCCGAC
ATTTGACTCCGAAAACGAGTCGACATGGAC|ATAGTGGGTACCCGGATCCCGACATAGTGG
TGTTTGATCCCGACATAGTGGGTACCCGCC|TTTCATAAAAATAATTAAAAGCAGCCCGCC
GGAATATGTGGCAGGCGGCAATAATCTCAT|GCATGGCAGAGGCTTGCACTTGTCACCTAA
ATGTTTTATGTTTGATCCCGACATAGTGGG|CATACGTATATAGGCAAAGTGCACATTAGA
CATAGTGGGTACCCGTTGATCCCGACATAG|ATCCGCGCGTACGGGGTCGGTATGTATGTT
GAGTTTTGATCCAATTACCATACGTATATA|GGAGTGTATGGACTTGTGCAATTTATTGTC
ATAGGCAAAGTGCACATTAGAGGATCAAGA|GTCTGTGTCTTGTAATGGTGAAGCTGACTA
GCCATCTTTATGTTTGATCCCGACATAGTG|ATCGCAGCTGCAAATACTTAAAGCGGTGCC
TTGCTATCGAGCAAAAATTATTTGACTCCG|TTTTATGTTTGATCCCGACATAGTGGGTAC
GATTTCATAAAAATAATTAAAAGCAGCCCG|CTTTTAGTGCTCTTCATTCGACATGTTCTA
GGTTGCTGATAGCTGGCCGTATGTTTGATC|AGTGGGTACCCGTATGTTTGATCCCGACAT
ACCGCAGGCTTAAAATAAAGAGATCGGAAT|CACGAACAGAACACTCCTCAAGTTAGCATG
TCCACACTGGACGCTTTATCGTCTACGTGC|TCTTGCAAAGTTCCCAGACGATCAGCCACC
TGCTCTTCATTCGACATGTTCTAGGCATCA|GGTACCCGCCGGGACACACAATCCACACTG
TGATCCCGACATAGTGGGTACCCGCCGGGA|GTGGCAGGCGGCAATAATCTCATTACGCAA
ATGTTTGATCCTATGTTTGATCCCGACATA|GAGGTGCAGCCATCTTTATGTTTGATCCCG
AGGCGAACTCTATCTTATAACGCAGAGCTA|AAACCGCAGGCTTAAAATAAAGAGATCGGA
ACGCTTTATCGTCTACGTGCGATCCCGGAG|TTCCCAGACGATCAGCCACCAAGCGGGTGG
GGTATAGGCCGCTTGCTATCGAGCAAAAAT|TGTATGAATATGTTTTATGTTTGATCCCGA
TCGACATGTTCTAGGCATCATGGAGAACCC|GGGACACACAATCCACACTGGACGCTTTAT
GATCTGAGTCGCCCGCTATGGTTGGAGTTT|AGTAAATACTTGCTTAACCCCAGCGGAGTG
ACCCGTATGTTTGATCCCGACATAGTGGGT|CTATGTTTGATCCCGACATAGTGGGTACCC
TGTTTGATCCCGACATAGTGGGTACCCGCC|ATATGTGGCAGGCGGCAATAATCTCATTAC
TGCGCTGAATCAATACGGTTGCTGATAGCT|CCGTTGATCCCGACATAGTGGGTACCCGTA
TTCGGACCTGTATGAATATGTTTTATGTTT|AGTTTTGATCCAATTACCATACGTATATAG
TGAGGGACTTTGATTTCATAAAAATAATTA|AAGGGGCCTGCCTTTTAGTGCTCTTCATTC
CATAGTGGGTACCCGGATCCCGACATAGTG|CACATTAGAGGATCAAGATAGGCTGAGGGA
AGCTGCAAATACTTAAAGCGGTGCCTCTCT|GGGTACCCGCCCGATCTGAGTCGCCCGCTA
ACGGGGTCGGTATGTATGTTTGATCCTATG|CCCGAAGTCGTAAATGAGGTGCAGCCATCT
TAGGCCGCTTGCTATCGAGCAAAAATTATT|TGAATATGTTTTATGTTTGATCCCGACATA
TGACTCCGAAAACGAGTCGACATGGACTCG|GTGGGTACCCGGATCCCGACATAGTGGGTA
GCAGCTGCAAATACTTAAAGCGGTGCCTCT|GTGGGTACCCGCCCGATCTGAGTCGCCCGC
TACCGATGGTGGTATAGGCCGCTTGCTATC|TCTTCGGACCTGTATGAATATGTTTTATGT
TTCGGCAGTTGGTCCAAAGAATACGTATAT|CCCGCGGCCGAAAACACGCTCGACCGTTCA
CAGACGATCAGCCACCAAGCGGGTGGGTCA|TTTACTCTGGCAAATTGTTTCAAAATTGCG
GTATGTTTGATCCTATGTTTGATCCCGACA|ATGAGGTGCAGCCATCTTTATGTTTGATCC
GTCGACATGGACTCGATATCCACAGACCAC|CCGACATAGTGGGTATATGTTTGATCCCGA
ACGAGTCGACATGGACTCGATATCCACAGA|GATCCCGACATAGTGGGTATATGTTTGATC
GTGTATGGACTTGTGCAATTTATTGTCTGT|TGATCCCGACATAGTGGGTACCCGACAAGG
GTGGGTACCCGCGACATAGTGGGTACCCGT|ACATAGTGGGTACCCGCTTACCGATGGTGG
CGGGTAGCACAGACCTTGTAGAAAAATCAT|AGTGGGTACCCGAATGTATGTTTGATCCCG
ATCCACACTGGACGCTTTATCGTCTACGTG|ATCTTGCAAAGTTCCCAGACGATCAGCCAC
CTGGAAAAGCGCAACTGCGCTGAATCAATA|CGACATAGTGGGTACCCGTTGATCCCGACA
GCTTACCGATGGTGGTATAGGCCGCTTGCT|TTATCTTCGGACCTGTATGAATATGTTTTA
CCATACGTATATAGGCAAAGTGCACATTAG|GCAATTTATTGTCTGTGTCTTGTAATGGTG
CATAGTGGGTACCCGCGACATAGTGGGTAC|CCCGACATAGTGGGTACCCGCTTACCGATG
CCTGCCTTTTAGTGCTCTTCATTCGACATG|CCCGACATAGTGGGTACCCGCCGGGACACA
CAAAGTGCACATTAGAGGATCAAGATAGGC|TGTCTTGTAATGGTGAAGCTGACTAAAGCA
AAAAGCAGCCCGCCGAGTAAATACTTGCTT|CGACATGTTCTAGGCATCATGGAGAACCCT
CGCCGGGACACACAATCCACACTGGACGCT|TTACGCAATGAAGAATCTTGCAAAGTTCCC
CGACATAGTGGGTACCCGGATCCCGACATA|GTGCACATTAGAGGATCAAGATAGGCTGAG
GACATAGTGGGTACCCGTTGATCCCGACAT|GAATCCGCGCGTACGGGGTCGGTATGTATG
TCTAGGCATCATGGAGAACCCTCACAGCTA|AATCCACACTGGACGCTTTATCGTCTACGT
ATCGGAATATGTGGCAGGCGGCAATAATCT|TTAGCATGGCAGAGGCTTGCACTTGTCACC
GTATGTTTGATCCCGACATAGTGGGTACCC|TGATCCCGACATAGTGGGTACTATGTTTGA
TGGGTACCCGAAGTCGTAAATGAGGTGCAG|CGACATGGACTCGATATCCACAGACCACCA
TCCCGACATAGTGGGTACCCGAATGTATGT|GGCCGCTTGCTATCGAGCAAAAATTATTTG
CATCTTTATGTTTGATCCCGACATAGTGGG|CGCAGCTGCAAATACTTAAAGCGGTGCCTC
CTTAAAATAAAGAGATCGGAATATGTGGCA|GAACACTCCTCAAGTTAGCATGGCAGAGGC
TAGTGGGTACCCGAAGTCGTAAATGAGGTG|AGTCGACATGGACTCGATATCCACAGACCA
GTGCACATTAGAGGATCAAGATAGGCTGAG|TTGTAATGGTGAAGCTGACTAAAGCAAAGG
CATGGACTCGATATCCACAGACCACCATCG|ATAGTGGGTATATGTTTGATCCCGACATAG
TCATGAATCCGCGCGTACGGGGTCGGTATG|CCCGACATAGTGGGTACCCGAAGTCGTAAA
CCCGACATAGTGGGTACCCGAATGTATGTT|GCCGCTTGCTATCGAGCAAAAATTATTTGA
CCTCTCTGGTTATCTTCGGACCTGTATGAA|CCCGCTATGGTTGGAGTTTTGATCCAATTA
GACATAGTGGGTACCCGACAAGGCGAACTC|GGAGCTGCGTATCACCGCTGAAACCGCAGG
AGCTGACTAAAGCAAAGGGGCCTGCCTTTT|AACGCAGAGCTATGTTTGATCCCGACATAG
GCTATGTTTGATCCCGACATAGTGGGTACC|ACGTGCGATCCCGGAGGAGCTGCGTATCAC
CGACATAGTGGGTACTATGTTTGATCCCGA|ATAGTGGGTACCCGCGACATAGTGGGTACC
CCGCTTACCGATGGTGGTATAGGCCGCTTG|GGTTATCTTCGGACCTGTATGAATATGTTT
ACCCGCCGGGACACACAATCCACACTGGAC|TCATTACGCAATGAAGAATCTTGCAAAGTT
TTTGATCCCGACATAGTGGGTACTATGTTT|ATCCCGACATAGTGGGTACCCGCGACATAG
ATTACCATACGTATATAGGCAAAGTGCACA|TTGTGCAATTTATTGTCTGTGTCTTGTAAT
GAAAAATCATGAATCCGCGCGTACGGGGTC|TTTGATCCCGACATAGTGGGTACCCGAAGT
ATTCGACATGTTCTAGGCATCATGGAGAAC|CCGGGACACACAATCCACACTGGACGCTTT
ATGTTATGTTTGATCCCGACATAGTGGGTA|CCTTGTAGAAAAATCATGAATCCGCGCGTA
TTTGACTCCGAAAACGAGTCGACATGGACT|TAGTGGGTACCCGGATCCCGACATAGTGGG
AAATAATTAAAAGCAGCCCGCCGAGTAAAT|TCTTCATTCGACATGTTCTAGGCATCATGG
CCGCCCGATCTGAGTCGCCCGCTATGGTTG|CCGCCGAGTAAATACTTGCTTAACCCCAGC
CGCAGGCTTAAAATAAAGAGATCGGAATAT|CGAACAGAACACTCCTCAAGTTAGCATGGC
CCCAACTGGAAAAGCGCAACTGCGCTGAAT|GATCCCGACATAGTGGGTACCCGTTGATCC
ATCCCGACATAGTGGGTACTATGTTTGATC|CGACATAGTGGGTACCCGCGACATAGTGGG
CCGACATAGTGGGTACCCGAATGTATGTTT|CCGCTTGCTATCGAGCAAAAATTATTTGAC
TGGGTATATGTTTGATCCCGACATAGTGGG|GACTTTGATTTCATAAAAATAATTAAAAGC
TTTAGTGCTCTTCATTCGACATGTTCTAGG|TAGTGGGTACCCGCCGGGACACACAATCCA
CGGCCGAAAACACGCTCGACCGTTCAATTA|CCCGACATAGTGGGTACCCGCCGGGTAGCA
ACCCGAAGTCGTAAATGAGGTGCAGCCATC|TGGACTCGATATCCACAGACCACCATCGCA
CGACATAGTGGGTACCCGCCCGATCTGAGT|ATAATTAAAAGCAGCCCGCCGAGTAAATAC
AATACTTGCTTAACCCCAGCGGAGTGTATG|TGGAGAACCCTCACAGCTATGTTTGATCCC
CGAACTCTATCTTATAACGCAGAGCTATGT|CCGCAGGCTTAAAATAAAGAGATCGGAATA
TCAATACGGTTGCTGATAGCTGGCCGTATG|CCGACATAGTGGGTACCCGTATGTTTGATC
CGGTATGTATGTTTGATCCTATGTTTGATC|TCGTAAATGAGGTGCAGCCATCTTTATGTT
TGCCTTTTAGTGCTCTTCATTCGACATGTT|CGACATAGTGGGTACCCGCCGGGACACACA
TTATTTGACTCCGAAAACGAGTCGACATGG|ACATAGTGGGTACCCGGATCCCGACATAGT
TACCCGAATGTATGTTTGATCCCGACATAG|AGCAAAAATTATTTGACTCCGAAAACGAGT
GGTACCCGTATGTTTGATCCCGACATAGTG|ATCCTATGTTTGATCCCGACATAGTGGGTA
CCGACAAGGCGAACTCTATCTTATAACGCA|CCGCTGAAACCGCAGGCTTAAAATAAAGAG
CGCTCGACCGTTCAATTATCTTATGTTATG|GGTACCCGCCGGGTAGCACAGACCTTGTAG
AGCAAAAATTATTTGACTCCGAAAACGAGT|TGATCCCGACATAGTGGGTACCCGGATCCC
AAAATAAAGAGATCGGAATATGTGGCAGGC|CACTCCTCAAGTTAGCATGGCAGAGGCTTG
CCGGGACACACAATCCACACTGGACGCTTT|ACGCAATGAAGAATCTTGCAAAGTTCCCAG
TTTGATCCCGACATAGTGGGTACCCGCTTA|AATACTTAAAGCGGTGCCTCTCTGGTTATC
CTCGATATCCACAGACCACCATCGCAGCTG|GGTATATGTTTGATCCCGACATAGTGGGTA
ACTCTATCTTATAACGCAGAGCTATGTTTG|CAGGCTTAAAATAAAGAGATCGGAATATGT
GGACGCTTTATCGTCTACGTGCGATCCCGG|AGTTCCCAGACGATCAGCCACCAAGCGGGT
GTTTGATCCCGACATAGTGGGTACCCGCCG|TATGTGGCAGGCGGCAATAATCTCATTACG
CGGGACACACAATCCACACTGGACGCTTTA|CGCAATGAAGAATCTTGCAAAGTTCCCAGA
ACGTGCGATCCCGGAGGAGCTGCGTATCAC|GCCACCAAGCGGGTGGGTCAGCGTAGTTGT
CCCGCGACATAGTGGGTACCCGTTTGATCC|GGGTACCCGCTTACCGATGGTGGTATAGGC
CCGAAAACGAGTCGACATGGACTCGATATC|TACCCGGATCCCGACATAGTGGGTATATGT
TATGTTTTATGTTTGATCCCGACATAGTGG|CCATACGTATATAGGCAAAGTGCACATTAG
GCGACATAGTGGGTACCCGTTTGATCCCGA|TACCCGCTTACCGATGGTGGTATAGGCCGC
TGGGTACTATGTTTGATCCCGACATAGTGG|TACCCGCGACATAGTGGGTACCCGTTTGAT
TTGATCCCGACATAGTGGGTACCCGCCCGA|CATAAAAATAATTAAAAGCAGCCCGCCGAG
AGTGCACATTAGAGGATCAAGATAGGCTGA|CTTGTAATGGTGAAGCTGACTAAAGCAAAG
ATTGTCTGTGTCTTGTAATGGTGAAGCTGA|CCGACAAGGCGAACTCTATCTTATAACGCA
GTATAGGCCGCTTGCTATCGAGCAAAAATT|GTATGAATATGTTTTATGTTTGATCCCGAC
CTGACTAAAGCAAAGGGGCCTGCCTTTTAG|CGCAGAGCTATGTTTGATCCCGACATAGTG
TTATCTTATGTTATGTTTGATCCCGACATA|GCACAGACCTTGTAGAAAAATCATGAATCC
GAAAACGAGTCGACATGGACTCGATATCCA|CCCGGATCCCGACATAGTGGGTATATGTTT
CTCATTACGCAATGAAGAATCTTGCAAAGT|CCTAACTACTGAGCGCATACATGCTTTGAG
GTGGGTACCCGCCCGATCTGAGTCGCCCGC|AAAGCAGCCCGCCGAGTAAATACTTGCTTA
TTTGATCCCGACATAGTGGGTACCCGCGGC|CCGACATAGTGGGTACTATGTTTGATCCCG
TGATCCCGACATAGTGGGTACCCGCCCGAT|ATAAAAATAATTAAAAGCAGCCCGCCGAGT
GGAGGAGCTGCGTATCACCGCTGAAACCGC|GTGGGTCAGCGTAGTTGTTACTGAACACGA
GCCCGCCGAGTAAATACTTGCTTAACCCCA|TTCTAGGCATCATGGAGAACCCTCACAGCT
GTATATAGGCAAAGTGCACATTAGAGGATC|TATTGTCTGTGTCTTGTAATGGTGAAGCTG
GACCTGTATGAATATGTTTTATGTTTGATC|TTGATCCAATTACCATACGTATATAGGCAA
GAATACGTATATTTACAGATAAGCCAACCT|CTCGACCGTTCAATTATCTTATGTTATGTT
GGCAGTTGGTCCAAAGAATACGTATATTTA|GCGGCCGAAAACACGCTCGACCGTTCAATT
ATCTTCGGACCTGTATGAATATGTTTTATG|TGGAGTTTTGATCCAATTACCATACGTATA
CATAAAAATAATTAAAAGCAGCCCGCCGAG|AGTGCTCTTCATTCGACATGTTCTAGGCAT
CCGGGTAGCACAGACCTTGTAGAAAAATCA|TAGTGGGTACCCGAATGTATGTTTGATCCC
TCACAGCTATGTTTGATCCCGACATAGTGG|CGTCTACGTGCGATCCCGGAGGAGCTGCGT
GTACCCGTTGATCCCGACATAGTGGGTACC|GTACGGGGTCGGTATGTATGTTTGATCCTA
GCCAACCTGCCCAACTGGAAAAGCGCAACT|GTTATGTTTGATCCCGACATAGTGGGTACC
ACTCCGAAAACGAGTCGACATGGACTCGAT|GGGTACCCGGATCCCGACATAGTGGGTATA
TGCGATCCCGGAGGAGCTGCGTATCACCGC|ACCAAGCGGGTGGGTCAGCGTAGTTGTTAC
TTGGAGTTTTGATCCAATTACCATACGTAT|AGCGGAGTGTATGGACTTGTGCAATTTATT
GACCGTTCAATTATCTTATGTTATGTTTGA|CCGCCGGGTAGCACAGACCTTGTAGAAAAA
GCCTGCCTTTTAGTGCTCTTCATTCGACAT|TCCCGACATAGTGGGTACCCGCCGGGACAC
GCTATGGTTGGAGTTTTGATCCAATTACCA|TAACCCCAGCGGAGTGTATGGACTTGTGCA
TCTCTGGTTATCTTCGGACCTGTATGAATA|CGCTATGGTTGGAGTTTTGATCCAATTACC
CGCTTACCGATGGTGGTATAGGCCGCTTGC|GTTATCTTCGGACCTGTATGAATATGTTTT
TAGTGGGTACTATGTTTGATCCCGACATAG|GGGTACCCGCGACATAGTGGGTACCCGTTT
TAGGCATCATGGAGAACCCTCACAGCTATG|TCCACACTGGACGCTTTATCGTCTACGTGC
ACCCGGATCCCGACATAGTGGGTATATGTT|GATCAAGATAGGCTGAGGGACTTTGATTTC
TGTATGGACTTGTGCAATTTATTGTCTGTG|GATCCCGACATAGTGGGTACCCGACAAGGC
CCGACATAGTGGGTACCCGCGGCCGAAAAC|AGTGGGTACTATGTTTGATCCCGACATAGT
ATAGTGGGTACCCGCCGGGTAGCACAGACC|GTTTGATCCCGACATAGTGGGTACCCGAAT
ACCCCAGCGGAGTGTATGGACTTGTGCAAT|ACAGCTATGTTTGATCCCGACATAGTGGGT
CCGGATCCCGACATAGTGGGTATATGTTTG|TCAAGATAGGCTGAGGGACTTTGATTTCAT
TACCCGCCGGGACACACAATCCACACTGGA|CTCATTACGCAATGAAGAATCTTGCAAAGT
GTTGGTCCAAAGAATACGTATATTTACAGA|CCGAAAACACGCTCGACCGTTCAATTATCT
GTACCCGCGACATAGTGGGTACCCGTTTGA|AGTGGGTACCCGCTTACCGATGGTGGTATA
AACCTGCCCAACTGGAAAAGCGCAACTGCG|ATGTTTGATCCCGACATAGTGGGTACCCGT
GAAGTCGTAAATGAGGTGCAGCCATCTTTA|CTCGATATCCACAGACCACCATCGCAGCTG
CCGCGGCCGAAAACACGCTCGACCGTTCAA|GATCCCGACATAGTGGGTACCCGCCGGGTA
GCAAAGGGGCCTGCCTTTTAGTGCTCTTCA|ATGTTTGATCCCGACATAGTGGGTACCCGC
CTTATGTTATGTTTGATCCCGACATAGTGG|AGACCTTGTAGAAAAATCATGAATCCGCGC
TTTGATCCCGACATAGTGGGTACCCGCCCG|TCATAAAAATAATTAAAAGCAGCCCGCCGA
TATCGTCTACGTGCGATCCCGGAGGAGCTG|GACGATCAGCCACCAAGCGGGTGGGTCAGC
CCGAGTAAATACTTGCTTAACCCCAGCGGA|GGCATCATGGAGAACCCTCACAGCTATGTT
GTCGCCCGCTATGGTTGGAGTTTTGATCCA|ACTTGCTTAACCCCAGCGGAGTGTATGGAC
TGGGTACCCGCCGGGACACACAATCCACAC|TAATCTCATTACGCAATGAAGAATCTTGCA
CATACGTATATAGGCAAAGTGCACATTAGA|CAATTTATTGTCTGTGTCTTGTAATGGTGA
ATGTATGTTTGATCCTATGTTTGATCCCGA|AAATGAGGTGCAGCCATCTTTATGTTTGAT
TTTGATCCCGACATAGTGGGTACCCGGATC|TAGGCAAAGTGCACATTAGAGGATCAAGAT
CCTGTATGAATATGTTTTATGTTTGATCCC|GATCCAATTACCATACGTATATAGGCAAAG
CAGTTGGTCCAAAGAATACGTATATTTACA|GGCCGAAAACACGCTCGACCGTTCAATTAT
ATAACGCAGAGCTATGTTTGATCCCGACAT|ATAAAGAGATCGGAATATGTGGCAGGCGGC
TTGATCCCGACATAGTGGGTACCCGCGGCC|CGACATAGTGGGTACTATGTTTGATCCCGA
CCAGCGGAGTGTATGGACTTGTGCAATTTA|GCTATGTTTGATCCCGACATAGTGGGTACC
CCCGACATAGTGGGTACCCGCGGCCGAAAA|TAGTGGGTACTATGTTTGATCCCGACATAG
ATAGTGGGTACCCGGATCCCGACATAGTGG|ACATTAGAGGATCAAGATAGGCTGAGGGAC
CTGCGTATCACCGCTGAAACCGCAGGCTTA|AGCGTAGTTGTTACTGAACACGAACAGAAC
GTTATGTTTGATCCCGACATAGTGGGTACC|TTGTAGAAAAATCATGAATCCGCGCGTACG
TCCCGACATAGTGGGTACCCGCCCGATCTG|AAAATAATTAAAAGCAGCCCGCCGAGTAAA
GCCCGCTATGGTTGGAGTTTTGATCCAATT|TGCTTAACCCCAGCGGAGTGTATGGACTTG
GCTTAAAATAAAGAGATCGGAATATGTGGC|AGAACACTCCTCAAGTTAGCATGGCAGAGG
ATCCACAGACCACCATCGCAGCTGCAAATA|TGTTTGATCCCGACATAGTGGGTACCCGCC
TAAAGCAAAGGGGCCTGCCTTTTAGTGCTC|AGCTATGTTTGATCCCGACATAGTGGGTAC
CCTATGTTTGATCCCGACATAGTGGGTACC|CCATCTTTATGTTTGATCCCGACATAGTGG
CGGATCCCGACATAGTGGGTATATGTTTGA|CAAGATAGGCTGAGGGACTTTGATTTCATA
GAGATCGGAATATGTGGCAGGCGGCAATAA|AAGTTAGCATGGCAGAGGCTTGCACTTGTC
AAAGCGCAACTGCGCTGAATCAATACGGTT|TAGTGGGTACCCGTTGATCCCGACATAGTG
CATTACGCAATGAAGAATCTTGCAAAGTTC|TAACTACTGAGCGCATACATGCTTTGAGCT
GGGGCCTGCCTTTTAGTGCTCTTCATTCGA|TGATCCCGACATAGTGGGTACCCGCCGGGA
TGCAGCCATCTTTATGTTTGATCCCGACAT|CACCATCGCAGCTGCAAATACTTAAAGCGG
ATGAAGAATCTTGCAAAGTTCCCAGACGAT|AGCGCATACATGCTTTGAGCTTTTTACTCT
AGTGGGTACCCGCCGGGACACACAATCCAC|AATAATCTCATTACGCAATGAAGAATCTTG
GCAAATACTTAAAGCGGTGCCTCTCTGGTT|ACCCGCCCGATCTGAGTCGCCCGCTATGGT
TAGTGGGTACCCGTATGTTTGATCCCGACA|GTTTGATCCTATGTTTGATCCCGACATAGT
TTGATCCCGACATAGTGGGTACCCGACAAG|ATCCCGGAGGAGCTGCGTATCACCGCTGAA
CGCCCGCTATGGTTGGAGTTTTGATCCAAT|TTGCTTAACCCCAGCGGAGTGTATGGACTT
AGCAGCCCGCCGAGTAAATACTTGCTTAAC|CATGTTCTAGGCATCATGGAGAACCCTCAC
GGGTAGCACAGACCTTGTAGAAAAATCATG|GTGGGTACCCGAATGTATGTTTGATCCCGA
GACATAGTGGGTACCCGTATGTTTGATCCC|GTATGTTTGATCCTATGTTTGATCCCGACA
AAAGGGGCCTGCCTTTTAGTGCTCTTCATT|GTTTGATCCCGACATAGTGGGTACCCGCCG
GTATCACCGCTGAAACCGCAGGCTTAAAAT|TAGTTGTTACTGAACACGAACAGAACACTC
ATATAGGCAAAGTGCACATTAGAGGATCAA|TTGTCTGTGTCTTGTAATGGTGAAGCTGAC
TGTATGAATATGTTTTATGTTTGATCCCGA|TCCAATTACCATACGTATATAGGCAAAGTG
TGTGGCAGGCGGCAATAATCTCATTACGCA|CAGAGGCTTGCACTTGTCACCTAACTACTG
GGGTACCCGCCGGGTAGCACAGACCTTGTA|ATCCCGACATAGTGGGTACCCGAATGTATG
CCGAAGTCGTAAATGAGGTGCAGCCATCTT|GACTCGATATCCACAGACCACCATCGCAGC
GAATCTTGCAAAGTTCCCAGACGATCAGCC|ATACATGCTTTGAGCTTTTTACTCTGGCAA
TGGTCCAAAGAATACGTATATTTACAGATA|GAAAACACGCTCGACCGTTCAATTATCTTA
ATCGCAGCTGCAAATACTTAAAGCGGTGCC|ATAGTGGGTACCCGCCCGATCTGAGTCGCC
TGATCCCGACATAGTGGGTACCCGCGGCCG|GACATAGTGGGTACTATGTTTGATCCCGAC
CGTCTACGTGCGATCCCGGAGGAGCTGCGT|GATCAGCCACCAAGCGGGTGGGTCAGCGTA
TGAATCCGCGCGTACGGGGTCGGTATGTAT|GACATAGTGGGTACCCGAAGTCGTAAATGA
CACATTAGAGGATCAAGATAGGCTGAGGGA|TAATGGTGAAGCTGACTAAAGCAAAGGGGC
GTAAATGAGGTGCAGCCATCTTTATGTTTG|ATCCACAGACCACCATCGCAGCTGCAAATA
ATGTGGCAGGCGGCAATAATCTCATTACGC|GCAGAGGCTTGCACTTGTCACCTAACTACT
CATAGTGGGTACCCGAATGTATGTTTGATC|TTGCTATCGAGCAAAAATTATTTGACTCCG
TGTAATGGTGAAGCTGACTAAAGCAAAGGG|CTCTATCTTATAACGCAGAGCTATGTTTGA
GTATGAATATGTTTTATGTTTGATCCCGAC|CCAATTACCATACGTATATAGGCAAAGTGC
AGCCAACCTGCCCAACTGGAAAAGCGCAAC|TGTTATGTTTGATCCCGACATAGTGGGTAC
TAAAGAGATCGGAATATGTGGCAGGCGGCA|CCTCAAGTTAGCATGGCAGAGGCTTGCACT
ACCACCATCGCAGCTGCAAATACTTAAAGC|CCCGACATAGTGGGTACCCGCCCGATCTGA
AGTGGGTACCCGAAGTCGTAAATGAGGTGC|GTCGACATGGACTCGATATCCACAGACCAC
GGTACCCGTTTGATCCCGACATAGTGGGTA|CGATGGTGGTATAGGCCGCTTGCTATCGAG
TGTAGAAAAATCATGAATCCGCGCGTACGG|TATGTTTGATCCCGACATAGTGGGTACCCG
ACTGGACGCTTTATCGTCTACGTGCGATCC|CAAAGTTCCCAGACGATCAGCCACCAAGCG
TATGTTTGATCCCGACATAGTGGGTACCCG|ATTTGACTCCGAAAACGAGTCGACATGGAC
ATGAATATGTTTTATGTTTGATCCCGACAT|AATTACCATACGTATATAGGCAAAGTGCAC
ACAATCCACACTGGACGCTTTATCGTCTAC|AGAATCTTGCAAAGTTCCCAGACGATCAGC
ATCTGAGTCGCCCGCTATGGTTGGAGTTTT|GTAAATACTTGCTTAACCCCAGCGGAGTGT
GGCAGGCGGCAATAATCTCATTACGCAATG|AGGCTTGCACTTGTCACCTAACTACTGAGC
ATGTTTGATCCCGACATAGTGGGTACCCGC|AATATGTGGCAGGCGGCAATAATCTCATTA
TACCCGCGACATAGTGGGTACCCGTTTGAT|GTGGGTACCCGCTTACCGATGGTGGTATAG
AGATCGGAATATGTGGCAGGCGGCAATAAT|AGTTAGCATGGCAGAGGCTTGCACTTGTCA
TGGGTACCCGGATCCCGACATAGTGGGTAT|TAGAGGATCAAGATAGGCTGAGGGACTTTG
GATCCCGGAGGAGCTGCGTATCACCGCTGA|AAGCGGGTGGGTCAGCGTAGTTGTTACTGA
TATTTACAGATAAGCCAACCTGCCCAACTG|TCAATTATCTTATGTTATGTTTGATCCCGA
GAAGCTGACTAAAGCAAAGGGGCCTGCCTT|ATAACGCAGAGCTATGTTTGATCCCGACAT
TAATCTCATTACGCAATGAAGAATCTTGCA|GTCACCTAACTACTGAGCGCATACATGCTT
TGCTGATAGCTGGCCGTATGTTTGATCCCG|GGGTACCCGTATGTTTGATCCCGACATAGT
CAATTTATTGTCTGTGTCTTGTAATGGTGA|GGGTACCCGACAAGGCGAACTCTATCTTAT
TGTTTGATCCCGACATAGTGGGTACCCGCG|CTTTATGTTTGATCCCGACATAGTGGGTAC
AATTACCATACGTATATAGGCAAAGTGCAC|CTTGTGCAATTTATTGTCTGTGTCTTGTAA
ATAGTGGGTACCCGCTTACCGATGGTGGTA|GGTGCCTCTCTGGTTATCTTCGGACCTGTA
AGAGCTATGTTTGATCCCGACATAGTGGGT|GATCGGAATATGTGGCAGGCGGCAATAATC
GTGGGTACCCGTATGTTTGATCCCGACATA|TTGATCCTATGTTTGATCCCGACATAGTGG
ATGGAGAACCCTCACAGCTATGTTTGATCC|GGACGCTTTATCGTCTACGTGCGATCCCGG
CCCGTTGATCCCGACATAGTGGGTACCCGT|CGGGGTCGGTATGTATGTTTGATCCTATGT
CCAACTGGAAAAGCGCAACTGCGCTGAATC|ATCCCGACATAGTGGGTACCCGTTGATCCC
ATTTACAGATAAGCCAACCTGCCCAACTGG|CAATTATCTTATGTTATGTTTGATCCCGAC
TAAAAATAATTAAAAGCAGCCCGCCGAGTA|TGCTCTTCATTCGACATGTTCTAGGCATCA
CGATCCCGGAGGAGCTGCGTATCACCGCTG|CAAGCGGGTGGGTCAGCGTAGTTGTTACTG
TAGTGGGTATATGTTTGATCCCGACATAGT|AGGGACTTTGATTTCATAAAAATAATTAAA
CGTACGGGGTCGGTATGTATGTTTGATCCT|GTACCCGAAGTCGTAAATGAGGTGCAGCCA
GTACCCGCGGCCGAAAACACGCTCGACCGT|GTTTGATCCCGACATAGTGGGTACCCGCCG
TCCCGACATAGTGGGTACCCGCGGCCGAAA|ATAGTGGGTACTATGTTTGATCCCGACATA
CCCGTATGTTTGATCCCGACATAGTGGGTA|TATGTTTGATCCCGACATAGTGGGTACCCG
GTACCCGTATGTTTGATCCCGACATAGTGG|TCCTATGTTTGATCCCGACATAGTGGGTAC
GGGCCTGCCTTTTAGTGCTCTTCATTCGAC|GATCCCGACATAGTGGGTACCCGCCGGGAC
AAATGAGGTGCAGCCATCTTTATGTTTGAT|CCACAGACCACCATCGCAGCTGCAAATACT
TACTATGTTTGATCCCGACATAGTGGGTAC|CGCGACATAGTGGGTACCCGTTTGATCCCG
CCGCAGGCTTAAAATAAAGAGATCGGAATA|ACGAACAGAACACTCCTCAAGTTAGCATGG
TTACGCAATGAAGAATCTTGCAAAGTTCCC|ACTACTGAGCGCATACATGCTTTGAGCTTT
TGGTGAAGCTGACTAAAGCAAAGGGGCCTG|TCTTATAACGCAGAGCTATGTTTGATCCCG
GACATAGTGGGTACCCGCCCGATCTGAGTC|TAATTAAAAGCAGCCCGCCGAGTAAATACT
AGGCTGAGGGACTTTGATTTCATAAAAATA|AGCAAAGGGGCCTGCCTTTTAGTGCTCTTC
CCGACATAGTGGGTACCCGAAGTCGTAAAT|AAAACGAGTCGACATGGACTCGATATCCAC
GTATGTATGTTTGATCCTATGTTTGATCCC|GTAAATGAGGTGCAGCCATCTTTATGTTTG
GTCGGTATGTATGTTTGATCCTATGTTTGA|AGTCGTAAATGAGGTGCAGCCATCTTTATG
GAGCTGCGTATCACCGCTGAAACCGCAGGC|GTCAGCGTAGTTGTTACTGAACACGAACAG
CATAGTGGGTATATGTTTGATCCCGACATA|TGAGGGACTTTGATTTCATAAAAATAATTA
TTGATCCCGACATAGTGGGTACCCGGATCC|AGGCAAAGTGCACATTAGAGGATCAAGATA
GGCGAACTCTATCTTATAACGCAGAGCTAT|AACCGCAGGCTTAAAATAAAGAGATCGGAA
GCCGAAAACACGCTCGACCGTTCAATTATC|CGACATAGTGGGTACCCGCCGGGTAGCACA
ACATAGTGGGTACCCGGATCCCGACATAGT|GCACATTAGAGGATCAAGATAGGCTGAGGG
TAGTGGGTACCCGCGACATAGTGGGTACCC|CGACATAGTGGGTACCCGCTTACCGATGGT
AGACGATCAGCCACCAAGCGGGTGGGTCAG|TTACTCTGGCAAATTGTTTCAAAATTGCGC
AGGCAAAGTGCACATTAGAGGATCAAGATA|CTGTGTCTTGTAATGGTGAAGCTGACTAAA
GCCCGATCTGAGTCGCCCGCTATGGTTGGA|GCCGAGTAAATACTTGCTTAACCCCAGCGG
CGCAGAGCTATGTTTGATCCCGACATAGTG|AGAGATCGGAATATGTGGCAGGCGGCAATA
CTCGACCGTTCAATTATCTTATGTTATGTT|TACCCGCCGGGTAGCACAGACCTTGTAGAA
ATGTTTGATCCCGACATAGTGGGTACCCGC|ATTTCATAAAAATAATTAAAAGCAGCCCGC
TTGACTCCGAAAACGAGTCGACATGGACTC|AGTGGGTACCCGGATCCCGACATAGTGGGT
TATGAATATGTTTTATGTTTGATCCCGACA|CAATTACCATACGTATATAGGCAAAGTGCA
CAAAGAATACGTATATTTACAGATAAGCCA|CACGCTCGACCGTTCAATTATCTTATGTTA
CGACCGTTCAATTATCTTATGTTATGTTTG|CCCGCCGGGTAGCACAGACCTTGTAGAAAA
TTGATCCCGACATAGTGGGTACCCGCTTAC|ATACTTAAAGCGGTGCCTCTCTGGTTATCT
CTAAAGCAAAGGGGCCTGCCTTTTAGTGCT|GAGCTATGTTTGATCCCGACATAGTGGGTA
GGGTATATGTTTGATCCCGACATAGTGGGT|ACTTTGATTTCATAAAAATAATTAAAAGCA
GACATAGTGGGTACCCGCTTACCGATGGTG|AGCGGTGCCTCTCTGGTTATCTTCGGACCT
TTCATAAAAATAATTAAAAGCAGCCCGCCG|TTAGTGCTCTTCATTCGACATGTTCTAGGC
TTGATTTCATAAAAATAATTAAAAGCAGCC|GCCTTTTAGTGCTCTTCATTCGACATGTTC
GACTTTGATTTCATAAAAATAATTAAAAGC|GCCTGCCTTTTAGTGCTCTTCATTCGACAT
ACATGGACTCGATATCCACAGACCACCATC|CATAGTGGGTATATGTTTGATCCCGACATA
TCATGGAGAACCCTCACAGCTATGTTTGAT|CTGGACGCTTTATCGTCTACGTGCGATCCC
AAGCTGACTAAAGCAAAGGGGCCTGCCTTT|TAACGCAGAGCTATGTTTGATCCCGACATA
GCTCGACCGTTCAATTATCTTATGTTATGT|GTACCCGCCGGGTAGCACAGACCTTGTAGA
TCGCCCGCTATGGTTGGAGTTTTGATCCAA|CTTGCTTAACCCCAGCGGAGTGTATGGACT
TGTTTGATCCTATGTTTGATCCCGACATAG|AGGTGCAGCCATCTTTATGTTTGATCCCGA
AAATACTTAAAGCGGTGCCTCTCTGGTTAT|CCGCCCGATCTGAGTCGCCCGCTATGGTTG
GAATGTATGTTTGATCCCGACATAGTGGGT|AAATTATTTGACTCCGAAAACGAGTCGACA
AAATAAAGAGATCGGAATATGTGGCAGGCG|ACTCCTCAAGTTAGCATGGCAGAGGCTTGC
AAAATTATTTGACTCCGAAAACGAGTCGAC|CCCGACATAGTGGGTACCCGGATCCCGACA
TCGCAGCTGCAAATACTTAAAGCGGTGCCT|TAGTGGGTACCCGCCCGATCTGAGTCGCCC
TGGGTACCCGAATGTATGTTTGATCCCGAC|ATCGAGCAAAAATTATTTGACTCCGAAAAC
GGGTACCCGAAGTCGTAAATGAGGTGCAGC|GACATGGACTCGATATCCACAGACCACCAT
CTCTGGTTATCTTCGGACCTGTATGAATAT|GCTATGGTTGGAGTTTTGATCCAATTACCA
TTTATTGTCTGTGTCTTGTAATGGTGAAGC|TACCCGACAAGGCGAACTCTATCTTATAAC
CAAAGGGGCCTGCCTTTTAGTGCTCTTCAT|TGTTTGATCCCGACATAGTGGGTACCCGCC
CCGACATAGTGGGTACCCGCCGGGTAGCAC|TACCCGTTTGATCCCGACATAGTGGGTACC
ATCCCGACATAGTGGGTATATGTTTGATCC|GATAGGCTGAGGGACTTTGATTTCATAAAA
TCCCGACATAGTGGGTACCCGCCGGGTAGC|GGTACCCGTTTGATCCCGACATAGTGGGTA
TATCTTATAACGCAGAGCTATGTTTGATCC|CTTAAAATAAAGAGATCGGAATATGTGGCA
TCCCGACATAGTGGGTACCCGTTGATCCCG|TCATGAATCCGCGCGTACGGGGTCGGTATG
CTTCGGACCTGTATGAATATGTTTTATGTT|GAGTTTTGATCCAATTACCATACGTATATA
TGCACATTAGAGGATCAAGATAGGCTGAGG|TGTAATGGTGAAGCTGACTAAAGCAAAGGG
GCAGGCGGCAATAATCTCATTACGCAATGA|GGCTTGCACTTGTCACCTAACTACTGAGCG
GGTATATGTTTGATCCCGACATAGTGGGTA|CTTTGATTTCATAAAAATAATTAAAAGCAG
ATAGTGGGTACCCGAATGTATGTTTGATCC|TGCTATCGAGCAAAAATTATTTGACTCCGA
ACCTGCCCAACTGGAAAAGCGCAACTGCGC|TGTTTGATCCCGACATAGTGGGTACCCGTT
TGCGTATCACCGCTGAAACCGCAGGCTTAA|GCGTAGTTGTTACTGAACACGAACAGAACA
GCTGGCCGTATGTTTGATCCCGACATAGTG|GTATGTTTGATCCCGACATAGTGGGTACTA
ATAGTGGGTATATGTTTGATCCCGACATAG|GAGGGACTTTGATTTCATAAAAATAATTAA
ATAGTGGGTACCCGTTTGATCCCGACATAG|GCTTACCGATGGTGGTATAGGCCGCTTGCT
CACCGCTGAAACCGCAGGCTTAAAATAAAG|TGTTACTGAACACGAACAGAACACTCCTCA
AACACGCTCGACCGTTCAATTATCTTATGT|AGTGGGTACCCGCCGGGTAGCACAGACCTT
GTATGGACTTGTGCAATTTATTGTCTGTGT|ATCCCGACATAGTGGGTACCCGACAAGGCG
GATCCAATTACCATACGTATATAGGCAAAG|ATGGACTTGTGCAATTTATTGTCTGTGTCT
CTTGCTATCGAGCAAAAATTATTTGACTCC|GTTTTATGTTTGATCCCGACATAGTGGGTA
TAGTGGGTACCCGCTTACCGATGGTGGTAT|GTGCCTCTCTGGTTATCTTCGGACCTGTAT
CTTCATTCGACATGTTCTAGGCATCATGGA|CCCGCCGGGACACACAATCCACACTGGACG
GTAGCACAGACCTTGTAGAAAAATCATGAA|GGGTACCCGAATGTATGTTTGATCCCGACA
CTGCCCAACTGGAAAAGCGCAACTGCGCTG|TTTGATCCCGACATAGTGGGTACCCGTTGA
ACGTATATTTACAGATAAGCCAACCTGCCC|ACCGTTCAATTATCTTATGTTATGTTTGAT
ATATCCACAGACCACCATCGCAGCTGCAAA|TATGTTTGATCCCGACATAGTGGGTACCCG
TGAGGTGCAGCCATCTTTATGTTTGATCCC|CAGACCACCATCGCAGCTGCAAATACTTAA
TGAAGAATCTTGCAAAGTTCCCAGACGATC|GCGCATACATGCTTTGAGCTTTTTACTCTG
AGTGGGTACCCGACAAGGCGAACTCTATCT|TGCGTATCACCGCTGAAACCGCAGGCTTAA
CATAGTGGGTACCCGTATGTTTGATCCCGA|ATGTTTGATCCTATGTTTGATCCCGACATA
TGGGTACCCGACAAGGCGAACTCTATCTTA|CGTATCACCGCTGAAACCGCAGGCTTAAAA
GATCCCGACATAGTGGGTACCCGCGACATA|TGTTTGATCCCGACATAGTGGGTACCCGCT
CTTAAAGCGGTGCCTCTCTGGTTATCTTCG|CGATCTGAGTCGCCCGCTATGGTTGGAGTT

GGTTCGGCAGTTGGTCCAAAGAATACGTATATTTACAGATAAGCCAACCTGCCCAACTGGAAAAGCGCAACTGCGCTGAATCAATACGGTTGCTGATAGCTGGCCGTATGTTTGATCCCGACATAGTGGGTACCCGCGGCCGAAAACACGCTCGACCGTTCAATTATCTTATGTTATGTTTGATCCCGACATAGTGGGTACCCGTTGATCCCGACATAGTGGGTACCCGTATGTTTGATCCCGACATAGTGGGTACTATGTTTGATCCCGACATAGTGGGTACCCGCCGGGTAGCACAGACCTTGTAGAAAAATCATGAATCCGCGCGTACGGGGTCGGTATGTATGTTTGATCCTATGTTTGATCCCGACATAGTGGGTACCCGCGACATAGTGGGTACCCGTTTGATCCCGACATAGTGGGTACCCGAATGTATGTTTGATCCCGACATAGTGGGTACCCGAAGTCGTAAATGAGGTGCAGCCATCTTTATGTTTGATCCCGACATAGTGGGTACCCGCTTACCGATGGTGGTATAGGCCGCTTGCTATCGAGCAAAAATTATTTGACTCCGAAAACGAGTCGACATGGACTCGATATCCACAGACCACCATCGCAGCTGCAAATACTTAAAGCGGTGCCTCTCTGGTTATCTTCGGACCTGTATGAATATGTTTTATGTTTGATCCCGACATAGTGGGTACCCGGATCCCGACATAGTGGGTATATGTTTGATCCCGACATAGTGGGTACCCGCCCGATCTGAGTCGCCCGCTATGGTTGGAGTTTTGATCCAATTACCATACGTATATAGGCAAAGTGCACATTAGAGGATCAAGATAGGCTGAGGGACTTTGATTTCATAAAAATAATTAAAAGCAGCCCGCCGAGTAAATACTTGCTTAACCCCAGCGGAGTGTATGGACTTGTGCAATTTATTGTCTGTGTCTTGTAATGGTGAAGCTGACTAAAGCAAAGGGGCCTGCCTTTTAGTGCTCTTCATTCGACATGTTCTAGGCATCATGGAGAACCCTCACAGCTATGTTTGATCCCGACATAGTGGGTACCCGACAAGGCGAACTCTATCTTATAACGCAGAGCTATGTTTGATCCCGACATAGTGGGTACCCGCCGGGACACACAATCCACACTGGACGCTTTATCGTCTACGTGCGATCCCGGAGGAGCTGCGTATCACCGCTGAAACCGCAGGCTTAAAATAAAGAGATCGGAATATGTGGCAGGCGGCAATAATCTCATTACGCAATGAAGAATCTTGCAAAGTTCCCAGACGATCAGCCACCAAGCGGGTGGGTCAGCGTAGTTGTTACTGAACACGAACAGAACACTCCTCAAGTTAGCATGGCAGAGGCTTGCACTTGTCACCTAACTACTGAGCGCATACATGCTTTGAGCTTTTTACTCTGGCAAATTGTTTCAAAATTGCGCG
